Week_Ending,Vehicle,Beginning_Mileage,Ending_Mileage,Total_Miles,Office,Year,Make,Model
10/2/2021,147,211705,211947,242,DN,2008,Chevy,Silverado
10/23/2021,147,212838,212893,55,DN,2008,Chevy,Silverado
1/1/2022,147,212893,212923,30,DN,2008,Chevy,Silverado
1/29/2022,147,212963,213013,50,DN,2008,Chevy,Silverado
2/5/2022,147,213013,213063,50,DN,2008,Chevy,Silverado
2/12/2022,147,213065,213141,76,DN,2008,Chevy,Silverado
2/19/2022,147,213141,213179,38,DN,2008,Chevy,Silverado
2/26/2022,147,213179,213247,68,DN,2008,Chevy,Silverado
3/26/2022,147,213247,213393,146,DN,2008,Chevy,Silverado
4/2/2022,147,213393,213433,40,DN,2008,Chevy,Silverado
10/2/2021,160,65945,66002,57,CS,2013,Chevy,Silverado
10/9/2021,160,66002,66037,35,CS,2013,Chevy,Silverado
10/16/2021,160,66037,66063,26,CS,2013,Chevy,Silverado
10/23/2021,160,66063,66131,68,CS,2013,Chevy,Silverado
10/30/2021,160,66131,66246,115,CS,2013,Chevy,Silverado
11/6/2021,160,66246,66315,69,CS,2013,Chevy,Silverado
11/13/2021,160,66315,66361,46,CS,2013,Chevy,Silverado
11/20/2021,160,66361,66442,81,CS,2013,Chevy,Silverado
12/4/2021,160,66442,66514,72,CS,2013,Chevy,Silverado
12/11/2021,160,66514,66570,56,CS,2013,Chevy,Silverado
12/18/2021,160,66570,66629,59,CS,2013,Chevy,Silverado
12/25/2021,160,66629,66667,38,CS,2013,Chevy,Silverado
1/1/2022,160,66667,66707,40,CS,2013,Chevy,Silverado
1/8/2022,160,66707,66776,69,CS,2013,Chevy,Silverado
1/15/2022,160,66776,66839,63,CS,2013,Chevy,Silverado
1/22/2022,160,66839,66885,46,CS,2013,Chevy,Silverado
1/29/2022,160,66885,66942,57,CS,2013,Chevy,Silverado
2/5/2022,160,66942,67000,58,CS,2013,Chevy,Silverado
2/12/2022,160,67000,67057,57,CS,2013,Chevy,Silverado
2/19/2022,160,67057,67115,58,CS,2013,Chevy,Silverado
2/26/2022,160,67115,67177,62,CS,2013,Chevy,Silverado
3/5/2022,160,67177,67234,57,CS,2013,Chevy,Silverado
3/12/2022,160,67234,67292,58,CS,2013,Chevy,Silverado
3/19/2022,160,67292,67332,40,CS,2013,Chevy,Silverado
4/2/2022,160,67332,67377,45,CS,2013,Chevy,Silverado
10/9/2021,168,174564,175120,556,PK,2013,Chevy,Silverado
10/16/2021,168,175247,175420,173,PK,2013,Chevy,Silverado
10/23/2021,168,175420,176190,770,PK,2013,Chevy,Silverado
10/30/2021,168,176190,177013,823,PK,2013,Chevy,Silverado
11/6/2021,168,177013,177671,658,PK,2013,Chevy,Silverado
11/13/2021,168,177671,178344,673,PK,2013,Chevy,Silverado
11/20/2021,168,178344,179125,781,PK,2013,Chevy,Silverado
11/27/2021,168,179125,179376,251,PK,2013,Chevy,Silverado
12/4/2021,168,179376,179919,543,PK,2013,Chevy,Silverado
12/11/2021,168,179919,180434,515,PK,2013,Chevy,Silverado
12/18/2021,168,180434,181070,636,PK,2013,Chevy,Silverado
1/15/2022,168,182044,182659,615,PK,2013,Chevy,Silverado
1/22/2022,168,182659,182999,340,PK,2013,Chevy,Silverado
1/29/2022,168,182999,183259,260,PK,2013,Chevy,Silverado
10/16/2021,170,116831,117415,584,DN,2013,Ford,F-150
3/5/2022,170,119326,119637,311,DN,2013,Ford,F-150
3/12/2022,170,119637,120018,381,DN,2013,Ford,F-150
10/2/2021,171,144273,145023,750,DN,2013,Ford,F-150
10/9/2021,171,145023,145307,284,DN,2013,Ford,F-150
10/16/2021,171,145307,146015,708,DN,2013,Ford,F-150
10/23/2021,171,146015,146427,412,DN,2013,Ford,F-150
12/11/2021,171,147550,147858,308,DN,2013,Ford,F-150
1/29/2022,171,148511,148975,464,DN,2013,Ford,F-150
2/12/2022,171,148975,149550,575,DN,2013,Ford,F-150
2/19/2022,171,149550,150875,1325,DN,2013,Ford,F-150
3/12/2022,171,152980,153670,690,DN,2013,Ford,F-150
3/19/2022,171,153670,154900,1230,DN,2013,Ford,F-150
3/26/2022,171,154900,156880,1980,DN,2013,Ford,F-150
10/9/2021,172,145000,145611,611,PK,2013,Ford,F-150
10/16/2021,172,145611,146092,481,PK,2013,Ford,F-150
10/23/2021,172,146092,146786,694,PK,2013,Ford,F-150
10/30/2021,172,146786,147197,411,PK,2013,Ford,F-150
11/6/2021,172,147197,147530,333,PK,2013,Ford,F-150
11/13/2021,172,147530,147690,160,PK,2013,Ford,F-150
11/20/2021,172,147690,148090,400,PK,2013,Ford,F-150
11/27/2021,172,148090,148270,180,PK,2013,Ford,F-150
12/18/2021,172,148738,148955,217,PK,2013,Ford,F-150
10/2/2021,174,153936,154342,406,DN,2014,Ford,F-150
10/9/2021,174,154342,154914,572,DN,2014,Ford,F-150
10/16/2021,174,155004,155602,598,DN,2014,Ford,F-150
10/23/2021,174,155700,156400,700,DN,2014,Ford,F-150
10/30/2021,174,156552,157105,553,DN,2014,Ford,F-150
11/6/2021,174,157105,157600,495,DN,2014,Ford,F-150
11/20/2021,174,158017,158498,481,DN,2014,Ford,F-150
11/27/2021,174,158498,158900,402,DN,2014,Ford,F-150
12/18/2021,174,159711,160152,441,DN,2014,Ford,F-150
12/25/2021,174,160152,160535,383,DN,2014,Ford,F-150
1/1/2022,174,160535,160931,396,DN,2014,Ford,F-150
1/8/2022,174,160931,161420,489,DN,2014,Ford,F-150
1/15/2022,174,161420,161910,490,DN,2014,Ford,F-150
1/22/2022,174,161910,162421,511,DN,2014,Ford,F-150
1/29/2022,174,162421,163023,602,DN,2014,Ford,F-150
2/5/2022,174,163023,163456,433,DN,2014,Ford,F-150
2/12/2022,174,163456,164100,644,DN,2014,Ford,F-150
2/19/2022,174,164100,164613,513,DN,2014,Ford,F-150
2/26/2022,174,164613,165070,457,DN,2014,Ford,F-150
3/5/2022,174,165070,165543,473,DN,2014,Ford,F-150
3/12/2022,174,165543,165911,368,DN,2014,Ford,F-150
3/19/2022,174,165911,166378,467,DN,2014,Ford,F-150
10/2/2021,177,128412,129094,682,CS,2014,Ford,F-150
10/9/2021,177,129094,129666,572,CS,2014,Ford,F-150
10/16/2021,177,129666,130216,550,CS,2014,Ford,F-150
10/23/2021,177,130216,130537,321,CS,2014,Ford,F-150
10/30/2021,177,130537,130979,442,CS,2014,Ford,F-150
11/6/2021,177,130979,131523,544,CS,2014,Ford,F-150
11/13/2021,177,131523,132072,549,CS,2014,Ford,F-150
11/20/2021,177,132072,132681,609,CS,2014,Ford,F-150
12/4/2021,177,132992,133206,214,CS,2014,Ford,F-150
10/2/2021,179,187412,187562,150,DN,2014,Ford,F-150
10/9/2021,179,187562,187712,150,DN,2014,Ford,F-150
10/16/2021,179,188162,188252,90,DN,2014,Ford,F-150
10/23/2021,179,188252,188322,70,DN,2014,Ford,F-150
11/6/2021,179,189172,189342,170,DN,2014,Ford,F-150
11/20/2021,179,189342,189462,120,DN,2014,Ford,F-150
11/27/2021,179,189462,189632,170,DN,2014,Ford,F-150
12/4/2021,179,189632,189792,160,DN,2014,Ford,F-150
12/11/2021,179,189900,190050,150,DN,2014,Ford,F-150
12/18/2021,179,190050,190235,185,DN,2014,Ford,F-150
12/25/2021,179,190235,190295,60,DN,2014,Ford,F-150
1/15/2022,179,190700,190855,155,DN,2014,Ford,F-150
1/22/2022,179,190975,191125,150,DN,2014,Ford,F-150
2/5/2022,179,191125,191215,90,DN,2014,Ford,F-150
2/12/2022,179,191400,191680,280,DN,2014,Ford,F-150
2/19/2022,179,191686,191836,150,DN,2014,Ford,F-150
2/26/2022,179,191836,192031,195,DN,2014,Ford,F-150
11/27/2021,183,114484,114636,152,DN,2014,Ford,F-150
2/19/2022,183,114648,114789,141,DN,2014,Ford,F-150
3/5/2022,183,114952,115142,190,DN,2014,Ford,F-150
3/12/2022,183,115259,115459,200,DN,2014,Ford,F-150
3/26/2022,183,115880,116120,240,DN,2014,Ford,F-150
10/2/2021,184,126171,126543,372,DN,2014,Ford,F-150
10/9/2021,184,126543,126959,416,DN,2014,Ford,F-150
10/16/2021,184,126959,127443,484,DN,2014,Ford,F-150
10/23/2021,184,127443,127801,358,DN,2014,Ford,F-150
10/30/2021,184,127801,128059,258,DN,2014,Ford,F-150
11/6/2021,184,128059,128463,404,DN,2014,Ford,F-150
11/13/2021,184,128463,128910,447,DN,2014,Ford,F-150
11/20/2021,184,128910,129315,405,DN,2014,Ford,F-150
11/27/2021,184,129315,129568,253,DN,2014,Ford,F-150
12/4/2021,184,129568,129913,345,DN,2014,Ford,F-150
12/18/2021,184,130296,130597,301,DN,2014,Ford,F-150
12/25/2021,184,130597,130732,135,DN,2014,Ford,F-150
1/1/2022,184,130732,130910,178,DN,2014,Ford,F-150
1/8/2022,184,130910,131058,148,DN,2014,Ford,F-150
1/15/2022,184,131058,131310,252,DN,2014,Ford,F-150
1/22/2022,184,131310,131410,100,DN,2014,Ford,F-150
1/29/2022,184,131410,131529,119,DN,2014,Ford,F-150
2/5/2022,184,131529,131770,241,DN,2014,Ford,F-150
2/12/2022,184,131770,132205,435,DN,2014,Ford,F-150
2/19/2022,184,132205,132533,328,DN,2014,Ford,F-150
2/26/2022,184,132533,132743,210,DN,2014,Ford,F-150
3/5/2022,184,132743,133138,395,DN,2014,Ford,F-150
3/12/2022,184,133138,133481,343,DN,2014,Ford,F-150
3/19/2022,184,133481,133895,414,DN,2014,Ford,F-150
3/26/2022,184,133895,134294,399,DN,2014,Ford,F-150
10/16/2021,185,124784,124811,27,PK,2015,Ford,F-150
10/30/2021,185,124836,125181,345,PK,2015,Ford,F-150
11/6/2021,185,125181,125266,85,PK,2015,Ford,F-150
11/13/2021,185,125266,125436,170,PK,2015,Ford,F-150
11/20/2021,185,125436,125744,308,PK,2015,Ford,F-150
11/27/2021,185,125744,125912,168,PK,2015,Ford,F-150
12/4/2021,185,125912,126172,260,PK,2015,Ford,F-150
12/11/2021,185,126172,126462,290,PK,2015,Ford,F-150
12/18/2021,185,126462,126601,139,PK,2015,Ford,F-150
1/15/2022,185,127457,127753,296,PK,2015,Ford,F-150
1/22/2022,185,127753,127960,207,PK,2015,Ford,F-150
1/29/2022,185,127960,128133,173,PK,2015,Ford,F-150
2/5/2022,185,128133,128327,194,PK,2015,Ford,F-150
2/12/2022,185,128327,128642,315,PK,2015,Ford,F-150
2/19/2022,185,128642,128943,301,PK,2015,Ford,F-150
2/26/2022,185,128943,128966,23,PK,2015,Ford,F-150
3/5/2022,185,129022,129637,615,PK,2015,Ford,F-150
3/12/2022,185,129637,130105,468,PK,2015,Ford,F-150
3/19/2022,185,130192,130676,484,PK,2015,Ford,F-150
3/26/2022,185,130676,131350,674,PK,2015,Ford,F-150
10/9/2021,186,115749,116308,559,PK,2015,Ford,F-150
10/16/2021,186,116308,116802,494,PK,2015,Ford,F-150
10/23/2021,186,116802,117262,460,PK,2015,Ford,F-150
10/30/2021,186,117262,117732,470,PK,2015,Ford,F-150
11/6/2021,186,117732,118164,432,PK,2015,Ford,F-150
11/13/2021,186,118164,118560,396,PK,2015,Ford,F-150
11/20/2021,186,118560,119327,767,PK,2015,Ford,F-150
11/27/2021,186,119327,119774,447,PK,2015,Ford,F-150
12/4/2021,186,119774,120532,758,PK,2015,Ford,F-150
12/11/2021,186,120532,121087,555,PK,2015,Ford,F-150
12/18/2021,186,121087,121550,463,PK,2015,Ford,F-150
1/15/2022,186,122754,123400,646,PK,2015,Ford,F-150
1/22/2022,186,123400,124224,824,PK,2015,Ford,F-150
1/29/2022,186,124224,124714,490,PK,2015,Ford,F-150
2/5/2022,186,124714,125196,482,PK,2015,Ford,F-150
2/19/2022,186,126094,126144,50,PK,2015,Ford,F-150
2/26/2022,186,126144,126629,485,PK,2015,Ford,F-150
3/5/2022,186,126629,127379,750,PK,2015,Ford,F-150
3/12/2022,186,127379,127935,556,PK,2015,Ford,F-150
3/26/2022,186,128568,129200,632,PK,2015,Ford,F-150
4/2/2022,186,129200,130074,874,PK,2015,Ford,F-150
4/9/2022,186,130074,130574,500,PK,2015,Ford,F-150
4/16/2022,186,130575,130809,234,PK,2015,Ford,F-150
10/9/2021,187,133715,134125,410,PK,2015,Ford,F-150
10/16/2021,187,134125,134770,645,PK,2015,Ford,F-150
10/23/2021,187,134770,135171,401,PK,2015,Ford,F-150
10/30/2021,187,135171,135687,516,PK,2015,Ford,F-150
11/6/2021,187,135687,136120,433,PK,2015,Ford,F-150
11/13/2021,187,136120,136515,395,PK,2015,Ford,F-150
11/20/2021,187,136515,136882,367,PK,2015,Ford,F-150
11/27/2021,187,136882,137022,140,PK,2015,Ford,F-150
12/4/2021,187,137022,137351,329,PK,2015,Ford,F-150
12/11/2021,187,137351,137477,126,PK,2015,Ford,F-150
12/18/2021,187,137477,137557,80,PK,2015,Ford,F-150
1/15/2022,187,137850,138263,413,PK,2015,Ford,F-150
1/22/2022,187,138263,138483,220,PK,2015,Ford,F-150
1/29/2022,187,138483,138760,277,PK,2015,Ford,F-150
2/19/2022,187,138957,139137,180,PK,2015,Ford,F-150
2/26/2022,187,139137,139266,129,PK,2015,Ford,F-150
3/5/2022,187,139266,139641,375,PK,2015,Ford,F-150
3/12/2022,187,139641,139965,324,PK,2015,Ford,F-150
3/19/2022,187,139965,140078,113,PK,2015,Ford,F-150
3/26/2022,187,140078,140680,602,PK,2015,Ford,F-150
4/2/2022,187,140680,141298,618,PK,2015,Ford,F-150
4/9/2022,187,141298,141678,380,PK,2015,Ford,F-150
4/16/2022,187,141678,142074,396,PK,2015,Ford,F-150
10/9/2021,190,123674,124034,360,PK,2014,Ford,F-150
10/16/2021,190,124034,124523,489,PK,2014,Ford,F-150
10/23/2021,190,124523,125084,561,PK,2014,Ford,F-150
10/30/2021,190,125084,125604,520,PK,2014,Ford,F-150
11/6/2021,190,125604,126140,536,PK,2014,Ford,F-150
11/13/2021,190,126140,126727,587,PK,2014,Ford,F-150
11/20/2021,190,126727,127277,550,PK,2014,Ford,F-150
12/4/2021,190,127590,128093,503,PK,2014,Ford,F-150
12/11/2021,190,128093,128472,379,PK,2014,Ford,F-150
12/18/2021,190,128472,128812,340,PK,2014,Ford,F-150
1/15/2022,190,129710,130051,341,PK,2014,Ford,F-150
1/22/2022,190,130051,130397,346,PK,2014,Ford,F-150
1/29/2022,190,130397,130631,234,PK,2014,Ford,F-150
2/12/2022,190,130738,131032,294,PK,2014,Ford,F-150
2/19/2022,190,131032,131358,326,PK,2014,Ford,F-150
2/26/2022,190,131358,131512,154,PK,2014,Ford,F-150
3/5/2022,190,131512,131924,412,PK,2014,Ford,F-150
3/12/2022,190,131924,132171,247,PK,2014,Ford,F-150
3/19/2022,190,132171,132474,303,PK,2014,Ford,F-150
3/26/2022,190,132747,132996,249,PK,2014,Ford,F-150
4/2/2022,190,132996,133382,386,PK,2014,Ford,F-150
4/9/2022,190,133382,133966,584,PK,2014,Ford,F-150
4/16/2022,190,133966,134417,451,PK,2014,Ford,F-150
10/9/2021,191,218843,218940,97,DN,2015,Ford,F-150
10/16/2021,191,218940,219868,928,DN,2015,Ford,F-150
10/23/2021,191,219868,219962,94,DN,2015,Ford,F-150
10/30/2021,191,220000,220940,940,DN,2015,Ford,F-150
11/6/2021,191,220940,221720,780,DN,2015,Ford,F-150
11/13/2021,191,221720,222380,660,DN,2015,Ford,F-150
11/20/2021,191,222380,223310,930,DN,2015,Ford,F-150
11/27/2021,191,223310,223720,410,DN,2015,Ford,F-150
12/4/2021,191,223720,224220,500,DN,2015,Ford,F-150
12/11/2021,191,224220,224940,720,DN,2015,Ford,F-150
12/18/2021,191,224940,225600,660,DN,2015,Ford,F-150
12/25/2021,191,225600,226050,450,DN,2015,Ford,F-150
1/1/2022,191,226050,226450,400,DN,2015,Ford,F-150
1/8/2022,191,226450,227050,600,DN,2015,Ford,F-150
1/15/2022,191,227050,227790,740,DN,2015,Ford,F-150
1/22/2022,191,227790,228150,360,DN,2015,Ford,F-150
1/29/2022,191,228150,228450,300,DN,2015,Ford,F-150
2/5/2022,191,228450,228840,390,DN,2015,Ford,F-150
2/12/2022,191,229590,230040,450,DN,2015,Ford,F-150
3/5/2022,191,230340,230920,580,DN,2015,Ford,F-150
3/12/2022,191,230920,231260,340,DN,2015,Ford,F-150
3/19/2022,191,231260,231850,590,DN,2015,Ford,F-150
3/19/2022,191,231850,232330,480,DN,2015,Ford,F-150
10/2/2021,192,136276,137008,732,DN,2014,Ford,F-150
10/9/2021,192,137008,137673,665,DN,2014,Ford,F-150
10/23/2021,192,138214,138715,501,DN,2014,Ford,F-150
10/30/2021,192,138715,139091,376,DN,2014,Ford,F-150
11/6/2021,192,139091,139517,426,DN,2014,Ford,F-150
11/13/2021,192,139517,139983,466,DN,2014,Ford,F-150
11/20/2021,192,139983,140536,553,DN,2014,Ford,F-150
11/27/2021,192,140536,140818,282,DN,2014,Ford,F-150
12/4/2021,192,140818,141167,349,DN,2014,Ford,F-150
12/11/2021,192,141167,141555,388,DN,2014,Ford,F-150
12/18/2021,192,141555,142208,653,DN,2014,Ford,F-150
12/25/2021,192,142208,142659,451,DN,2014,Ford,F-150
1/1/2022,192,142659,143026,367,DN,2014,Ford,F-150
1/8/2022,192,143026,143473,447,DN,2014,Ford,F-150
1/15/2022,192,143473,143929,456,DN,2014,Ford,F-150
1/22/2022,192,143929,144450,521,DN,2014,Ford,F-150
1/29/2022,192,144450,144847,397,DN,2014,Ford,F-150
2/5/2022,192,144847,145095,248,DN,2014,Ford,F-150
2/12/2022,192,145095,145501,406,DN,2014,Ford,F-150
2/19/2022,192,145501,146306,805,DN,2014,Ford,F-150
2/26/2022,192,146306,146783,477,DN,2014,Ford,F-150
3/5/2022,192,146783,147459,676,DN,2014,Ford,F-150
3/12/2022,192,147459,147998,539,DN,2014,Ford,F-150
3/19/2022,192,147998,148298,300,DN,2014,Ford,F-150
10/2/2021,193,122832,123403,571,CS,2013,Ford,F-150
10/9/2021,193,123403,124228,825,CS,2013,Ford,F-150
10/9/2021,193,124228,124952,724,CS,2013,Ford,F-150
10/23/2021,193,124952,125669,717,CS,2013,Ford,F-150
10/30/2021,193,125669,126014,345,CS,2013,Ford,F-150
11/6/2021,193,126014,126870,856,CS,2013,Ford,F-150
11/13/2021,193,127317,127476,159,CS,2013,Ford,F-150
11/20/2021,193,127476,127854,378,CS,2013,Ford,F-150
11/27/2021,193,127854,128002,148,CS,2013,Ford,F-150
12/4/2021,193,128002,128149,147,CS,2013,Ford,F-150
12/18/2021,193,128149,128463,314,CS,2013,Ford,F-150
12/25/2021,193,128463,128708,245,CS,2013,Ford,F-150
1/1/2022,193,128708,129011,303,CS,2013,Ford,F-150
1/8/2022,193,129011,129730,719,CS,2013,Ford,F-150
1/15/2022,193,129730,130150,420,PK,2013,Ford,F-150
1/22/2022,193,130150,130481,331,PK,2013,Ford,F-150
1/29/2022,193,130481,130679,198,PK,2013,Ford,F-150
2/5/2022,193,130679,130778,99,PK,2013,Ford,F-150
2/12/2022,193,130778,131063,285,PK,2013,Ford,F-150
2/26/2022,193,131063,131472,409,PK,2013,Ford,F-150
2/26/2022,193,131472,131541,69,PK,2013,Ford,F-150
3/5/2022,193,131541,132059,518,PK,2013,Ford,F-150
3/12/2022,193,132059,132462,403,PK,2013,Ford,F-150
3/26/2022,193,132462,132825,363,PK,2013,Ford,F-150
3/26/2022,193,149490,149532,42,PK,2013,Ford,F-150
4/2/2022,193,149532,149627,95,PK,2013,Ford,F-150
10/2/2021,195,129721,130338,617,FC,2016,Ford,F-150
10/9/2021,195,130338,130901,563,FC,2016,Ford,F-150
10/16/2021,195,130901,131435,534,FC,2016,Ford,F-150
10/23/2021,195,131442,132218,776,FC,2016,Ford,F-150
10/30/2021,195,132218,132628,410,FC,2016,Ford,F-150
11/6/2021,195,132628,133171,543,FC,2016,Ford,F-150
11/13/2021,195,133171,133619,448,FC,2016,Ford,F-150
11/20/2021,195,133633,134546,913,FC,2016,Ford,F-150
11/27/2021,195,134552,134918,366,FC,2016,Ford,F-150
12/4/2021,195,134918,135368,450,FC,2016,Ford,F-150
12/11/2021,195,135368,136071,703,FC,2016,Ford,F-150
12/18/2021,195,136071,136783,712,FC,2016,Ford,F-150
12/25/2021,195,136790,137129,339,FC,2016,Ford,F-150
1/1/2022,195,137186,137668,482,FC,2016,Ford,F-150
1/8/2022,195,137668,137887,219,FC,2016,Ford,F-150
2/26/2022,195,140656,140875,219,FC,2016,Ford,F-150
3/12/2022,195,141340,141759,419,FC,2016,Ford,F-150
3/19/2022,195,141786,142543,757,FC,2016,Ford,F-150
3/26/2022,195,142543,143241,698,FC,2016,Ford,F-150
4/2/2022,195,143241,144260,1019,FC,2016,Ford,F-150
11/6/2021,198,91372,91810,438,CS,2016,Ford,F-150
11/13/2021,198,91953,92274,321,CS,2016,Ford,F-150
11/20/2021,198,92274,92767,493,CS,2016,Ford,F-150
11/27/2021,198,92767,93382,615,CS,2016,Ford,F-150
12/4/2021,198,93382,93945,563,CS,2016,Ford,F-150
12/11/2021,198,93945,94447,502,CS,2016,Ford,F-150
12/18/2021,198,94447,94840,393,CS,2016,Ford,F-150
12/25/2021,198,94840,95131,291,CS,2016,Ford,F-150
1/8/2022,198,95551,96047,496,CS,2016,Ford,F-150
1/15/2022,198,96047,96482,435,CS,2016,Ford,F-150
1/22/2022,198,96482,96784,302,CS,2016,Ford,F-150
1/29/2022,198,96784,97207,423,CS,2016,Ford,F-150
2/5/2022,198,97207,97487,280,CS,2016,Ford,F-150
2/12/2022,198,97487,97908,421,CS,2016,Ford,F-150
2/19/2022,198,97908,98108,200,CS,2016,Ford,F-150
10/16/2021,199,57295,57677,382,CS,2016,Ford,F-150
10/30/2021,199,58242,58812,570,CS,2016,Ford,F-150
11/13/2021,199,59507,59888,381,CS,2016,Ford,F-150
11/27/2021,199,60621,60735,114,CS,2016,Ford,F-150
12/4/2021,199,60736,61252,516,CS,2016,Ford,F-150
12/11/2021,199,61252,61867,615,CS,2016,Ford,F-150
2/12/2022,199,62060,62197,137,CS,2016,Ford,F-150
2/19/2022,199,62197,62495,298,CS,2016,Ford,F-150
2/26/2022,199,62495,62701,206,CS,2016,Ford,F-150
3/5/2022,199,62779,63209,430,CS,2016,Ford,F-150
3/12/2022,199,63209,63632,423,CS,2016,Ford,F-150
3/19/2022,199,63632,64285,653,CS,2016,Ford,F-150
4/2/2022,199,65040,65779,739,CS,2016,Ford,F-150
9/11/2021,200,135259,135618,359,DN,2016,Ford,F-150
10/2/2021,200,135618,135824,206,DN,2016,Ford,F-150
10/9/2021,200,135824,136192,368,DN,2016,Ford,F-150
10/16/2021,200,136192,136524,332,DN,2016,Ford,F-150
10/23/2021,200,136524,137063,539,DN,2016,Ford,F-150
10/30/2021,200,137063,137348,285,DN,2016,Ford,F-150
11/6/2021,200,137645,138014,369,DN,2016,Ford,F-150
11/12/2021,200,138014,138369,355,DN,2016,Ford,F-150
11/20/2021,200,138369,138606,237,DN,2016,Ford,F-150
12/4/2021,200,138751,138938,187,DN,2016,Ford,F-150
12/11/2021,200,138938,139298,360,DN,2016,Ford,F-150
12/18/2021,200,139298,139512,214,DN,2016,Ford,F-150
12/25/2021,200,139512,139621,109,DN,2016,Ford,F-150
1/1/2022,200,139621,139842,221,DN,2016,Ford,F-150
1/8/2022,200,139842,140062,220,DN,2016,Ford,F-150
1/15/2022,200,140062,140288,226,DN,2016,Ford,F-150
1/29/2022,200,140288,140542,254,DN,2016,Ford,F-150
2/5/2022,200,140542,140705,163,DN,2016,Ford,F-150
2/19/2022,200,141075,141437,362,DN,2016,Ford,F-150
3/5/2022,200,141715,142007,292,DN,2016,Ford,F-150
3/12/2022,200,142007,142309,302,DN,2016,Ford,F-150
3/19/2022,200,142316,142559,243,DN,2016,Ford,F-150
10/16/2021,203,67080,67506,426,DN,2017,Ford,F-150
11/6/2021,203,68275,68550,275,DN,2017,Ford,F-150
11/13/2021,203,68550,68885,335,DN,2017,Ford,F-150
11/27/2021,203,69119,69360,241,DN,2017,Ford,F-150
12/4/2021,203,69360,69931,571,DN,2017,Ford,F-150
12/11/2021,203,69931,70421,490,DN,2017,Ford,F-150
12/18/2021,203,70421,70899,478,DN,2017,Ford,F-150
12/25/2021,203,70899,71108,209,DN,2017,Ford,F-150
1/1/2022,203,71108,71218,110,DN,2017,Ford,F-150
1/8/2022,203,71218,71781,563,DN,2017,Ford,F-150
1/15/2022,203,71781,72187,406,DN,2017,Ford,F-150
1/22/2022,203,72187,72639,452,DN,2017,Ford,F-150
1/29/2022,203,72639,73111,472,DN,2017,Ford,F-150
2/5/2022,203,73111,73678,567,DN,2017,Ford,F-150
2/12/2022,203,73678,74239,561,DN,2017,Ford,F-150
2/19/2022,203,74239,74559,320,DN,2017,Ford,F-150
2/26/2022,203,74559,74818,259,DN,2017,Ford,F-150
3/5/2022,203,74818,75317,499,DN,2017,Ford,F-150
3/19/2022,203,75719,75976,257,DN,2017,Ford,F-150
3/26/2022,203,75976,76381,405,DN,2017,Ford,F-150
4/2/2022,203,76381,76688,307,DN,2017,Ford,F-150
10/2/2021,204,106370,107010,640,DN,2017,Ford,F-150
10/9/2021,204,107010,107700,690,DN,2017,Ford,F-150
10/16/2021,204,107800,108310,510,DN,2017,Ford,F-150
10/23/2021,204,108310,108460,150,DN,2017,Ford,F-150
10/30/2021,204,108460,108690,230,DN,2017,Ford,F-150
11/6/2021,204,108690,108860,170,DN,2017,Ford,F-150
11/13/2021,204,108860,109050,190,DN,2017,Ford,F-150
11/20/2021,204,109050,109250,200,DN,2017,Ford,F-150
11/27/2021,204,109250,109450,200,DN,2017,Ford,F-150
12/4/2021,204,109460,109700,240,DN,2017,Ford,F-150
12/11/2021,204,109700,109960,260,DN,2017,Ford,F-150
12/18/2021,204,109960,110110,150,DN,2017,Ford,F-150
12/25/2021,204,110110,110410,300,DN,2017,Ford,F-150
1/1/2022,204,110430,110665,235,DN,2017,Ford,F-150
1/8/2022,204,110665,110920,255,DN,2017,Ford,F-150
1/15/2022,204,110920,111220,300,DN,2017,Ford,F-150
1/22/2022,204,111220,111500,280,DN,2017,Ford,F-150
1/29/2022,204,111610,111860,250,DN,2017,Ford,F-150
2/5/2022,204,111860,112190,330,DN,2017,Ford,F-150
2/19/2022,204,112700,113020,320,DN,2017,Ford,F-150
2/26/2022,204,113120,113420,300,DN,2017,Ford,F-150
3/5/2022,204,113420,113760,340,DN,2017,Ford,F-150
3/12/2022,204,113760,114200,440,DN,2017,Ford,F-150
3/19/2022,204,114200,114570,370,DN,2017,Ford,F-150
3/26/2022,204,114570,115155,585,DN,2017,Ford,F-150
10/2/2021,205,95857,96725,868,PK,2017,Ford,F-150
10/9/2021,205,96725,97666,941,PK,2017,Ford,F-150
10/16/2021,205,97666,98887,1221,PK,2017,Ford,F-150
10/23/2021,205,98887,99793,906,PK,2017,Ford,F-150
10/30/2021,205,99793,100636,843,PK,2017,Ford,F-150
11/13/2021,205,101361,102218,857,PK,2017,Ford,F-150
11/20/2021,205,102218,102711,493,PK,2017,Ford,F-150
12/4/2021,205,102711,103439,728,PK,2017,Ford,F-150
12/11/2021,205,103439,103977,538,PK,2017,Ford,F-150
12/18/2021,205,103977,104565,588,PK,2017,Ford,F-150
12/25/2021,205,104565,105157,592,PK,2017,Ford,F-150
1/1/2022,205,105157,105830,673,PK,2017,Ford,F-150
2/19/2022,205,106449,106755,306,PK,2017,Ford,F-150
2/26/2022,205,106755,106997,242,PK,2017,Ford,F-150
3/12/2022,205,107233,107612,379,PK,2017,Ford,F-150
3/19/2022,205,107612,107976,364,PK,2017,Ford,F-150
3/26/2022,205,107976,108359,383,PK,2017,Ford,F-150
4/2/2022,205,108359,108822,463,PK,2017,Ford,F-150
4/16/2022,205,109526,110317,791,PK,2017,Ford,F-150
10/2/2021,207,77615,77984,369,DN,2017,Ford,F-150
10/9/2021,207,77984,78154,170,DN,2017,Ford,F-150
10/16/2021,207,78154,78904,750,DN,2017,Ford,F-150
10/23/2021,207,78904,79258,354,DN,2017,Ford,F-150
10/30/2021,207,79258,79630,372,DN,2017,Ford,F-150
11/13/2021,207,80040,80420,380,DN,2017,Ford,F-150
11/20/2021,207,80420,80720,300,DN,2017,Ford,F-150
11/27/2021,207,80720,80753,33,DN,2017,Ford,F-150
12/4/2021,207,80753,81137,384,DN,2017,Ford,F-150
12/11/2021,207,81137,81508,371,DN,2017,Ford,F-150
12/18/2021,207,81508,81840,332,DN,2017,Ford,F-150
12/25/2021,207,81840,82014,174,DN,2017,Ford,F-150
1/8/2022,207,82377,82566,189,DN,2017,Ford,F-150
1/15/2022,207,82566,82596,30,DN,2017,Ford,F-150
1/22/2022,207,82596,82731,135,DN,2017,Ford,F-150
1/29/2022,207,82731,83107,376,DN,2017,Ford,F-150
2/5/2022,207,83107,83584,477,DN,2017,Ford,F-150
2/12/2022,207,83584,84118,534,DN,2017,Ford,F-150
2/19/2022,207,84118,84315,197,DN,2017,Ford,F-150
2/26/2022,207,84315,84641,326,DN,2017,Ford,F-150
3/5/2022,207,84641,85023,382,DN,2017,Ford,F-150
3/12/2022,207,85023,85378,355,DN,2017,Ford,F-150
3/19/2022,207,85378,85713,335,DN,2017,Ford,F-150
3/26/2022,207,85713,86133,420,DN,2017,Ford,F-150
4/2/2022,207,86133,86485,352,DN,2017,Ford,F-150
10/16/2021,208,98498,98972,474,CS,2017,Ford,F-150
10/23/2021,208,98972,99353,381,CS,2017,Ford,F-150
10/30/2021,208,99536,99719,183,CS,2017,Ford,F-150
10/9/2021,209,68052,68483,431,PK,2018,Ford,F-150
10/16/2021,209,68483,68907,424,PK,2018,Ford,F-150
10/23/2021,209,68907,69254,347,PK,2018,Ford,F-150
11/6/2021,209,69254,69830,576,PK,2018,Ford,F-150
11/13/2021,209,69830,70300,470,PK,2018,Ford,F-150
11/20/2021,209,70300,70806,506,PK,2018,Ford,F-150
11/27/2021,209,70806,71152,346,PK,2018,Ford,F-150
12/4/2021,209,71152,71610,458,PK,2018,Ford,F-150
12/11/2021,209,71610,72083,473,PK,2018,Ford,F-150
12/18/2021,209,72083,72468,385,PK,2018,Ford,F-150
1/15/2022,209,73600,74069,469,PK,2018,Ford,F-150
1/22/2022,209,74069,74477,408,PK,2018,Ford,F-150
1/29/2022,209,74477,74817,340,PK,2018,Ford,F-150
2/5/2022,209,74817,75457,640,PK,2018,Ford,F-150
2/19/2022,209,75922,76376,454,PK,2018,Ford,F-150
2/26/2022,209,76379,76831,452,PK,2018,Ford,F-150
3/5/2022,209,76831,77381,550,PK,2018,Ford,F-150
3/12/2022,209,77381,77815,434,PK,2018,Ford,F-150
3/19/2022,209,77815,78194,379,PK,2018,Ford,F-150
4/2/2022,209,78767,79518,751,PK,2018,Ford,F-150
4/9/2022,209,79518,80161,643,PK,2018,Ford,F-150
4/16/2022,209,80161,80758,597,PK,2018,Ford,F-150
10/2/2021,210,121596,122032,436,GS,2015,Toyota,Tacoma
10/9/2021,210,122032,122064,32,GS,2015,Toyota,Tacoma
10/16/2021,210,122064,122220,156,GS,2015,Toyota,Tacoma
10/23/2021,210,122220,122366,146,GS,2015,Toyota,Tacoma
10/30/2021,210,122366,122684,318,GS,2015,Toyota,Tacoma
11/6/2021,210,122684,122752,68,GS,2015,Toyota,Tacoma
11/13/2021,210,122752,122793,41,GS,2015,Toyota,Tacoma
11/20/2021,210,122793,123078,285,GS,2015,Toyota,Tacoma
11/27/2021,210,123078,123093,15,GS,2015,Toyota,Tacoma
12/18/2021,210,123317,123577,260,GS,2015,Toyota,Tacoma
12/25/2021,210,123696,123920,224,GS,2015,Toyota,Tacoma
1/1/2022,210,123920,124176,256,GS,2015,Toyota,Tacoma
1/15/2022,210,124179,124199,20,GS,2015,Toyota,Tacoma
3/26/2022,210,124199,124300,101,GS,2015,Toyota,Tacoma
10/2/2021,212,144439,145620,1181,FC,2018,Ford,F-150
10/16/2021,212,146670,147455,785,FC,2018,Ford,F-150
10/23/2021,212,147455,148613,1158,FC,2018,Ford,F-150
10/30/2021,212,148613,149865,1252,FC,2018,Ford,F-150
11/6/2021,212,149865,150674,809,FC,2018,Ford,F-150
11/27/2021,212,150674,151648,974,FC,2018,Ford,F-150
12/4/2021,212,151648,152319,671,FC,2018,Ford,F-150
12/4/2021,212,152319,153440,1121,FC,2018,Ford,F-150
12/11/2021,212,153440,154367,927,FC,2018,Ford,F-150
12/18/2021,212,154367,155337,970,FC,2018,Ford,F-150
1/8/2022,212,155337,156080,743,FC,2018,Ford,F-150
1/15/2022,212,156080,157594,1514,FC,2018,Ford,F-150
1/22/2022,212,157594,158493,899,FC,2018,Ford,F-150
1/29/2022,212,158493,159498,1005,FC,2018,Ford,F-150
2/5/2022,212,159498,160390,892,FC,2018,Ford,F-150
2/12/2022,212,160390,161483,1093,FC,2018,Ford,F-150
2/19/2022,212,161483,162513,1030,FC,2018,Ford,F-150
2/26/2022,212,162513,163430,917,FC,2018,Ford,F-150
3/5/2022,212,163430,164377,947,FC,2018,Ford,F-150
3/12/2022,212,164377,165219,842,FC,2018,Ford,F-150
3/19/2022,212,165219,166240,1021,FC,2018,Ford,F-150
3/26/2022,212,166240,167208,968,FC,2018,Ford,F-150
4/2/2022,212,167208,168234,1026,FC,2018,Ford,F-150
10/2/2021,213,128478,129299,821,GS,2018,Toyota,Tacoma
10/9/2021,213,129299,130018,719,GS,2018,Toyota,Tacoma
10/16/2021,213,130046,130792,746,GS,2018,Toyota,Tacoma
10/23/2021,213,130792,131270,478,GS,2018,Toyota,Tacoma
10/30/2021,213,131270,131931,661,GS,2018,Toyota,Tacoma
11/6/2021,213,131931,132528,597,GS,2018,Toyota,Tacoma
11/13/2021,213,132528,133131,603,GS,2018,Toyota,Tacoma
11/20/2021,213,133131,133869,738,GS,2018,Toyota,Tacoma
11/27/2021,213,133869,134205,336,GS,2018,Toyota,Tacoma
12/4/2021,213,134205,134951,746,GS,2018,Toyota,Tacoma
12/11/2021,213,134951,135513,562,GS,2018,Toyota,Tacoma
12/18/2021,213,135513,136041,528,GS,2018,Toyota,Tacoma
12/25/2021,213,136041,136434,393,GS,2018,Toyota,Tacoma
1/8/2022,213,136434,137117,683,GS,2018,Toyota,Tacoma
1/15/2022,213,137117,137886,769,GS,2018,Toyota,Tacoma
1/22/2022,213,137886,138358,472,GS,2018,Toyota,Tacoma
1/29/2022,213,138358,139043,685,GS,2018,Toyota,Tacoma
2/5/2022,213,139043,139673,630,GS,2018,Toyota,Tacoma
2/12/2022,213,139673,140300,627,GS,2018,Toyota,Tacoma
2/19/2022,213,140300,140837,537,GS,2018,Toyota,Tacoma
2/26/2022,213,140837,141393,556,GS,2018,Toyota,Tacoma
3/5/2022,213,141393,142185,792,GS,2018,Toyota,Tacoma
3/12/2022,213,142185,142396,211,GS,2018,Toyota,Tacoma
3/19/2022,213,142396,143122,726,GS,2018,Toyota,Tacoma
3/26/2022,213,143122,143719,597,GS,2018,Toyota,Tacoma
4/2/2022,213,143719,144192,473,GS,2018,Toyota,Tacoma
12/25/2021,215,100094,100162,68,DN,2018,Ford,F-150
1/1/2022,215,100162,100280,118,DN,2018,Ford,F-150
1/8/2022,215,100280,100496,216,DN,2018,Ford,F-150
1/15/2022,215,100496,100599,103,DN,2018,Ford,F-150
1/22/2022,215,100599,100810,211,DN,2018,Ford,F-150
1/29/2022,215,100810,100928,118,DN,2018,Ford,F-150
2/5/2022,215,100928,101179,251,DN,2018,Ford,F-150
2/19/2022,215,101179,101757,578,DN,2018,Ford,F-150
2/26/2022,215,101757,101850,93,DN,2018,Ford,F-150
3/5/2022,215,101856,102252,396,DN,2018,Ford,F-150
10/2/2021,216,95696,95897,201,GS,2014,Toyota,Tacoma
10/9/2021,216,95897,95973,76,GS,2014,Toyota,Tacoma
10/16/2021,216,95973,96268,295,GS,2014,Toyota,Tacoma
10/23/2021,216,96268,96487,219,GS,2014,Toyota,Tacoma
10/30/2021,216,96487,96705,218,GS,2014,Toyota,Tacoma
11/6/2021,216,96705,97178,473,GS,2014,Toyota,Tacoma
11/13/2021,216,97178,97474,296,GS,2014,Toyota,Tacoma
11/20/2021,216,97474,97839,365,GS,2014,Toyota,Tacoma
11/27/2021,216,97839,98084,245,GS,2014,Toyota,Tacoma
12/4/2021,216,98084,98400,316,GS,2014,Toyota,Tacoma
12/11/2021,216,98400,98545,145,GS,2014,Toyota,Tacoma
12/18/2021,216,98545,98897,352,GS,2014,Toyota,Tacoma
12/25/2021,216,98897,99066,169,GS,2014,Toyota,Tacoma
1/1/2022,216,99066,99225,159,GS,2014,Toyota,Tacoma
1/8/2022,216,99225,99369,144,GS,2014,Toyota,Tacoma
1/15/2022,216,99369,99853,484,GS,2014,Toyota,Tacoma
1/22/2022,216,99853,100127,274,GS,2014,Toyota,Tacoma
1/29/2022,216,100127,100463,336,GS,2014,Toyota,Tacoma
2/5/2022,216,100463,100781,318,GS,2014,Toyota,Tacoma
2/12/2022,216,100781,100881,100,GS,2014,Toyota,Tacoma
2/19/2022,216,100881,101141,260,GS,2014,Toyota,Tacoma
10/9/2021,217,76667,77132,465,PK,2018,Ford,F-150
10/16/2021,217,77132,77425,293,PK,2018,Ford,F-150
10/23/2021,217,77425,77887,462,PK,2018,Ford,F-150
10/30/2021,217,77887,78308,421,PK,2018,Ford,F-150
11/6/2021,217,78308,78671,363,PK,2018,Ford,F-150
11/13/2021,217,78671,79110,439,PK,2018,Ford,F-150
11/20/2021,217,79110,79482,372,PK,2018,Ford,F-150
11/27/2021,217,79482,79700,218,PK,2018,Ford,F-150
12/4/2021,217,79700,79752,52,PK,2018,Ford,F-150
12/11/2021,217,79752,79794,42,PK,2018,Ford,F-150
12/18/2021,217,79794,80329,535,PK,2018,Ford,F-150
1/15/2022,217,81387,81835,448,PK,2018,Ford,F-150
1/22/2022,217,81835,82212,377,PK,2018,Ford,F-150
1/29/2022,217,82212,82397,185,PK,2018,Ford,F-150
2/5/2022,217,82397,82811,414,PK,2018,Ford,F-150
2/19/2022,217,83161,83512,351,PK,2018,Ford,F-150
2/26/2022,217,83512,83779,267,PK,2018,Ford,F-150
3/5/2022,217,83779,84161,382,PK,2018,Ford,F-150
3/12/2022,217,84161,84594,433,PK,2018,Ford,F-150
3/19/2022,217,84594,85022,428,PK,2018,Ford,F-150
3/26/2022,217,85022,85469,447,PK,2018,Ford,F-150
4/2/2022,217,85469,85905,436,PK,2018,Ford,F-150
4/9/2022,217,85905,86474,569,PK,2018,Ford,F-150
4/16/2022,217,86474,86965,491,PK,2018,Ford,F-150
10/2/2021,218,50923,51615,692,DN,2018,Ford,F-150
10/9/2021,218,51615,51955,340,DN,2018,Ford,F-150
10/16/2021,218,51955,52357,402,DN,2018,Ford,F-150
10/23/2021,218,52357,52692,335,DN,2018,Ford,F-150
10/30/2021,218,52692,52781,89,DN,2018,Ford,F-150
11/6/2021,218,52781,53107,326,DN,2018,Ford,F-150
11/13/2021,218,53107,53626,519,DN,2018,Ford,F-150
11/20/2021,218,53626,54582,956,DN,2018,Ford,F-150
11/27/2021,218,54582,54594,12,DN,2018,Ford,F-150
12/4/2021,218,54594,54862,268,DN,2018,Ford,F-150
12/11/2021,218,54862,55115,253,DN,2018,Ford,F-150
12/18/2021,218,55115,55272,157,DN,2018,Ford,F-150
12/25/2021,218,55272,55479,207,DN,2018,Ford,F-150
1/15/2022,218,55568,55652,84,DN,2018,Ford,F-150
1/22/2022,218,55652,55675,23,DN,2018,Ford,F-150
1/29/2022,218,55675,55791,116,DN,2018,Ford,F-150
2/5/2022,218,55791,56149,358,DN,2018,Ford,F-150
2/19/2022,218,56149,56282,133,DN,2018,Ford,F-150
2/19/2022,218,56282,56366,84,DN,2018,Ford,F-150
2/26/2022,218,56366,56423,57,DN,2018,Ford,F-150
3/5/2022,218,56423,57102,679,DN,2018,Ford,F-150
3/12/2022,218,57102,57196,94,DN,2018,Ford,F-150
3/19/2022,218,57196,57345,149,DN,2018,Ford,F-150
3/26/2022,218,57345,58073,728,DN,2018,Ford,F-150
4/2/2022,218,58073,58497,424,DN,2018,Ford,F-150
10/2/2021,220,133880,134360,480,GS,2016,Toyota,Tacoma
10/16/2021,220,134650,135110,460,GS,2016,Toyota,Tacoma
10/23/2021,220,135110,135800,690,GS,2016,Toyota,Tacoma
10/30/2021,220,135800,136350,550,GS,2016,Toyota,Tacoma
11/6/2021,220,136350,136615,265,GS,2016,Toyota,Tacoma
11/13/2021,220,136615,137215,600,GS,2016,Toyota,Tacoma
11/20/2021,220,137215,137760,545,GS,2016,Toyota,Tacoma
11/27/2021,220,137760,138100,340,GS,2016,Toyota,Tacoma
12/4/2021,220,138100,138478,378,GS,2016,Toyota,Tacoma
10/2/2021,221,43280,43590,310,CS,2019,Ford,F-150
10/9/2021,221,43590,43870,280,CS,2019,Ford,F-150
10/16/2021,221,43870,44140,270,CS,2019,Ford,F-150
10/23/2021,221,44140,44310,170,CS,2019,Ford,F-150
10/30/2021,221,44310,44740,430,CS,2019,Ford,F-150
11/6/2021,221,44740,45150,410,CS,2019,Ford,F-150
11/13/2021,221,45150,45540,390,CS,2019,Ford,F-150
11/20/2021,221,45540,45940,400,CS,2019,Ford,F-150
11/27/2021,221,45940,46100,160,CS,2019,Ford,F-150
12/4/2021,221,46100,46480,380,CS,2019,Ford,F-150
12/11/2021,221,46480,46840,360,CS,2019,Ford,F-150
12/18/2021,221,46840,47600,760,CS,2019,Ford,F-150
12/25/2021,221,47600,48100,500,CS,2019,Ford,F-150
1/1/2022,221,48100,48420,320,CS,2019,Ford,F-150
1/8/2022,221,48420,48820,400,CS,2019,Ford,F-150
1/15/2022,221,48820,49140,320,CS,2019,Ford,F-150
1/22/2022,221,49140,49180,40,CS,2019,Ford,F-150
1/29/2022,221,49180,49330,150,CS,2019,Ford,F-150
2/5/2022,221,49330,49380,50,CS,2019,Ford,F-150
2/12/2022,221,49380,49670,290,CS,2019,Ford,F-150
2/19/2022,221,49670,50100,430,CS,2019,Ford,F-150
2/26/2022,221,50100,50270,170,CS,2019,Ford,F-150
3/5/2022,221,50270,50630,360,CS,2019,Ford,F-150
3/12/2022,221,50630,50820,190,CS,2019,Ford,F-150
3/19/2022,221,50820,51260,440,CS,2019,Ford,F-150
3/26/2022,221,51260,51520,260,CS,2019,Ford,F-150
4/2/2022,221,51520,51900,380,CS,2019,Ford,F-150
10/2/2021,222,35427,35741,314,CS,2019,Ford,F-150
10/9/2021,222,35741,36163,422,CS,2019,Ford,F-150
10/16/2021,222,36163,36490,327,CS,2019,Ford,F-150
10/23/2021,222,36490,36982,492,CS,2019,Ford,F-150
10/30/2021,222,36982,37688,706,CS,2019,Ford,F-150
12/11/2021,222,38728,39258,530,CS,2019,Ford,F-150
12/25/2021,222,39972,40379,407,CS,2019,Ford,F-150
1/1/2022,222,40379,40684,305,CS,2019,Ford,F-150
1/8/2022,222,40684,41188,504,CS,2019,Ford,F-150
1/15/2022,222,41188,41747,559,CS,2019,Ford,F-150
1/22/2022,222,41747,42263,516,CS,2019,Ford,F-150
1/29/2022,222,42263,42792,529,CS,2019,Ford,F-150
2/5/2022,222,42792,43124,332,CS,2019,Ford,F-150
2/12/2022,222,43124,43646,522,CS,2019,Ford,F-150
2/19/2022,222,43646,44168,522,CS,2019,Ford,F-150
2/26/2022,222,44168,44299,131,CS,2019,Ford,F-150
3/5/2022,222,44299,44841,542,CS,2019,Ford,F-150
3/12/2022,222,44841,45433,592,CS,2019,Ford,F-150
3/19/2022,222,45433,46078,645,CS,2019,Ford,F-150
3/26/2022,222,46078,46839,761,CS,2019,Ford,F-150
4/2/2022,222,46839,47638,799,CS,2019,Ford,F-150
9/4/2021,223,44141,44411,270,CS,2015,Ford,F-150
9/11/2021,223,44411,44833,422,CS,2015,Ford,F-150
9/18/2021,223,44833,45094,261,CS,2015,Ford,F-150
9/25/2021,223,45094,45349,255,CS,2015,Ford,F-150
10/2/2021,223,45349,45626,277,CS,2015,Ford,F-150
10/9/2021,223,45626,46299,673,CS,2015,Ford,F-150
10/16/2021,223,46299,46680,381,CS,2015,Ford,F-150
10/23/2021,223,46680,47080,400,CS,2015,Ford,F-150
10/30/2021,223,47080,47678,598,CS,2015,Ford,F-150
11/6/2021,223,47678,48072,394,CS,2015,Ford,F-150
11/13/2021,223,48072,48616,544,CS,2015,Ford,F-150
11/20/2021,223,48616,49057,441,CS,2015,Ford,F-150
11/27/2021,223,49057,49237,180,CS,2015,Ford,F-150
12/4/2021,223,49237,49447,210,CS,2015,Ford,F-150
12/11/2021,223,49447,49714,267,CS,2015,Ford,F-150
12/18/2021,223,49714,50070,356,CS,2015,Ford,F-150
12/25/2021,223,50070,50214,144,CS,2015,Ford,F-150
1/1/2022,223,50214,50352,138,CS,2015,Ford,F-150
1/8/2022,223,50352,50918,566,CS,2015,Ford,F-150
1/15/2022,223,50918,51131,213,CS,2015,Ford,F-150
1/22/2022,223,51131,51426,295,CS,2015,Ford,F-150
1/29/2022,223,51426,51815,389,CS,2015,Ford,F-150
2/5/2022,223,51815,51961,146,CS,2015,Ford,F-150
2/12/2022,223,51961,52284,323,CS,2015,Ford,F-150
2/19/2022,223,52284,52533,249,CS,2015,Ford,F-150
2/26/2022,223,52533,53033,500,CS,2015,Ford,F-150
3/5/2022,223,53033,53552,519,CS,2015,Ford,F-150
3/12/2022,223,53552,53976,424,CS,2015,Ford,F-150
3/19/2022,223,53976,54511,535,CS,2015,Ford,F-150
3/26/2022,223,54511,54939,428,CS,2015,Ford,F-150
4/2/2022,223,54939,55394,455,CS,2015,Ford,F-150
10/16/2021,224,43700,44260,560,DN,2019,Ford,F-150
10/30/2021,224,44260,44750,490,DN,2019,Ford,F-150
11/6/2021,224,44750,45102,352,DN,2019,Ford,F-150
11/13/2021,224,45102,45485,383,DN,2019,Ford,F-150
11/27/2021,224,45800,45965,165,DN,2019,Ford,F-150
12/4/2021,224,45965,46196,231,DN,2019,Ford,F-150
12/11/2021,224,46196,46560,364,DN,2019,Ford,F-150
12/18/2021,224,46560,46900,340,DN,2019,Ford,F-150
1/15/2022,224,47080,47360,280,DN,2019,Ford,F-150
3/26/2022,224,48889,49171,282,DN,2019,Ford,F-151
10/9/2021,225,63781,64565,784,PK,2019,Ford,F-150
10/16/2021,225,64565,64998,433,PK,2019,Ford,F-150
10/23/2021,225,64998,65550,552,PK,2019,Ford,F-150
10/30/2021,225,65550,66068,518,PK,2019,Ford,F-150
11/6/2021,225,66068,66714,646,PK,2019,Ford,F-150
11/13/2021,225,66714,67238,524,PK,2019,Ford,F-150
11/20/2021,225,67238,68062,824,PK,2019,Ford,F-150
11/27/2021,225,68062,68200,138,PK,2019,Ford,F-150
12/4/2021,225,68200,68815,615,PK,2019,Ford,F-150
12/11/2021,225,68815,69480,665,PK,2019,Ford,F-150
12/18/2021,225,69480,70037,557,PK,2019,Ford,F-150
1/15/2022,225,70778,71277,499,PK,2019,Ford,F-150
1/22/2022,225,71277,71809,532,PK,2019,Ford,F-150
1/29/2022,225,71809,72269,460,PK,2019,Ford,F-150
2/5/2022,225,72269,72641,372,PK,2019,Ford,F-150
2/19/2022,225,73132,73415,283,PK,2019,Ford,F-150
2/26/2022,225,73415,73827,412,PK,2019,Ford,F-150
3/5/2022,225,73827,74229,402,PK,2019,Ford,F-150
3/12/2022,225,74229,74562,333,PK,2019,Ford,F-150
3/19/2022,225,74562,74932,370,PK,2019,Ford,F-150
3/26/2022,225,74932,75499,567,PK,2019,Ford,F-150
4/2/2022,225,75499,76145,646,PK,2019,Ford,F-150
4/16/2022,225,76697,77271,574,PK,2019,Ford,F-150
1/23/2021,226,20000,20168,168,CS,2019,Ford,F-150
2/6/2021,226,20180,20300,120,CS,2019,Ford,F-150
10/2/2021,226,32703,33223,520,CS,2019,Ford,F-150
10/9/2021,226,33223,33850,627,CS,2019,Ford,F-150
11/6/2021,226,35072,35440,368,CS,2019,Ford,F-150
11/13/2021,226,35440,35753,313,CS,2019,Ford,F-150
11/20/2021,226,35753,36049,296,CS,2019,Ford,F-150
12/4/2021,226,36400,36689,289,CS,2019,Ford,F-150
12/18/2021,226,37397,37560,163,CS,2019,Ford,F-150
1/1/2022,226,37930,38090,160,CS,2019,Ford,F-150
10/2/2021,227,61169,61603,434,FC,2019,Ford,F-150
10/9/2021,227,61603,62373,770,FC,2019,Ford,F-150
10/23/2021,227,62995,63546,551,FC,2019,Ford,F-150
10/30/2021,227,63546,64388,842,FC,2019,Ford,F-150
11/6/2021,227,64388,64810,422,FC,2019,Ford,F-150
11/13/2021,227,64810,65202,392,FC,2019,Ford,F-150
11/20/2021,227,65202,65492,290,FC,2019,Ford,F-150
12/4/2021,227,65958,66632,674,FC,2019,Ford,F-150
12/11/2021,227,66632,67774,1142,FC,2019,Ford,F-150
12/18/2021,227,67774,69270,1496,FC,2019,Ford,F-150
12/25/2021,227,69270,70314,1044,FC,2019,Ford,F-150
1/1/2022,227,70314,70904,590,FC,2019,Ford,F-150
1/8/2022,227,70904,71186,282,FC,2019,Ford,F-150
1/15/2022,227,71186,72056,870,FC,2019,Ford,F-150
1/29/2022,227,72585,73014,429,FC,2019,Ford,F-150
2/5/2022,227,73014,73354,340,FC,2019,Ford,F-150
2/12/2022,227,73354,74414,1060,FC,2019,Ford,F-150
2/19/2022,227,74414,74964,550,FC,2019,Ford,F-150
2/26/2022,227,74964,75302,338,FC,2019,Ford,F-150
3/5/2022,227,75302,76314,1012,FC,2019,Ford,F-150
3/12/2022,227,76314,76810,496,FC,2019,Ford,F-150
3/19/2022,227,76810,77354,544,FC,2019,Ford,F-150
10/23/2021,228,26690,26758,68,SC,2019,Toyota,Tacoma
11/20/2021,228,26772,26924,152,SC,2019,Toyota,Tacoma
11/27/2021,228,26924,27124,200,SC,2019,Toyota,Tacoma
12/4/2021,228,27124,27233,109,SC,2019,Toyota,Tacoma
12/11/2021,228,27233,27376,143,SC,2019,Toyota,Tacoma
12/18/2021,228,27376,27639,263,SC,2019,Toyota,Tacoma
12/25/2021,228,27639,27925,286,SC,2019,Toyota,Tacoma
1/1/2022,228,27925,28068,143,SC,2019,Toyota,Tacoma
1/8/2022,228,28068,28257,189,SC,2019,Toyota,Tacoma
1/15/2022,228,28257,28339,82,SC,2019,Toyota,Tacoma
1/22/2022,228,28339,28841,502,SC,2019,Toyota,Tacoma
1/29/2022,228,28841,29160,319,SC,2019,Toyota,Tacoma
2/5/2022,228,29160,29295,135,SC,2019,Toyota,Tacoma
2/19/2022,228,29700,30192,492,SC,2019,Toyota,Tacoma
2/26/2022,228,30192,30250,58,SC,2019,Toyota,Tacoma
3/5/2022,228,30250,30875,625,SC,2019,Toyota,Tacoma
3/12/2022,228,30875,30999,124,SC,2019,Toyota,Tacoma
3/19/2022,228,30999,31190,191,SC,2019,Toyota,Tacoma
3/26/2022,228,31190,31731,541,SC,2019,Toyota,Tacoma
10/23/2021,229,21519,21945,426,DN,2020,Ford,F-150
10/30/2021,229,21945,22450,505,DN,2020,Ford,F-150
11/6/2021,229,22450,22874,424,DN,2020,Ford,F-150
11/13/2021,229,22874,23388,514,DN,2020,Ford,F-150
11/20/2021,229,23388,23779,391,DN,2020,Ford,F-150
11/27/2021,229,23779,24002,223,DN,2020,Ford,F-150
12/4/2021,229,24002,24438,436,DN,2020,Ford,F-150
12/18/2021,229,24903,25276,373,DN,2020,Ford,F-150
12/25/2021,229,25276,25570,294,DN,2020,Ford,F-150
1/1/2022,229,25570,25927,357,DN,2020,Ford,F-150
1/8/2022,229,25927,26238,311,DN,2020,Ford,F-150
1/15/2022,229,26238,26676,438,DN,2020,Ford,F-150
1/22/2022,229,26676,27037,361,DN,2020,Ford,F-150
3/5/2022,229,28554,29009,455,DN,2020,Ford,F-150
3/12/2022,229,29009,29300,291,DN,2020,Ford,F-150
3/26/2022,229,29656,30127,471,DN,2020,Ford,F-150
1/16/2021,230,20311,20605,294,CS,2019,Ford,F-150
10/2/2021,230,28508,29119,611,CS,2019,Ford,F-150
10/9/2021,230,29119,29816,697,CS,2019,Ford,F-150
10/16/2021,230,29816,30301,485,CS,2019,Ford,F-150
10/23/2021,230,30301,31230,929,CS,2019,Ford,F-150
10/30/2021,230,31230,31911,681,CS,2019,Ford,F-150
11/6/2021,230,31911,32658,747,CS,2019,Ford,F-150
11/13/2021,230,32658,33548,890,CS,2019,Ford,F-150
11/20/2021,230,33548,34409,861,CS,2019,Ford,F-150
11/27/2021,230,34409,35223,814,CS,2019,Ford,F-150
12/4/2021,230,35223,35968,745,CS,2019,Ford,F-150
12/11/2021,230,35968,36760,792,CS,2019,Ford,F-150
12/18/2021,230,36760,37170,410,CS,2019,Ford,F-150
12/25/2021,230,37170,37814,644,CS,2019,Ford,F-150
1/1/2022,230,37814,38412,598,CS,2019,Ford,F-150
1/8/2022,230,38412,38787,375,CS,2019,Ford,F-150
1/15/2022,230,38787,39387,600,CS,2019,Ford,F-150
1/22/2022,230,39387,40062,675,CS,2019,Ford,F-150
1/29/2022,230,40062,40685,623,CS,2019,Ford,F-150
2/5/2022,230,40685,41246,561,CS,2019,Ford,F-150
2/12/2022,230,41246,41992,746,CS,2019,Ford,F-150
2/26/2022,230,42713,43144,431,CS,2019,Ford,F-150
3/5/2022,230,43144,43611,467,CS,2019,Ford,F-150
10/2/2021,231,47332,47589,257,DN,2018,Ford,F-150
10/9/2021,231,47589,47804,215,DN,2018,Ford,F-150
10/16/2021,231,47804,48047,243,DN,2018,Ford,F-150
10/23/2021,231,48047,48381,334,DN,2018,Ford,F-150
11/13/2021,231,48435,48644,209,DN,2018,Ford,F-150
11/20/2021,231,48644,48906,262,DN,2018,Ford,F-150
11/27/2021,231,48906,49146,240,DN,2018,Ford,F-150
12/4/2021,231,49146,49326,180,DN,2018,Ford,F-150
12/11/2021,231,49326,49594,268,DN,2018,Ford,F-150
12/18/2021,231,49594,49800,206,DN,2018,Ford,F-150
10/2/2021,232,113360,113644,284,SC,2015,Toyota,Tacoma
10/23/2021,232,113644,114102,458,SC,2015,Toyota,Tacoma
10/30/2021,232,114102,114686,584,SC,2015,Toyota,Tacoma
11/6/2021,232,114686,115027,341,SC,2015,Toyota,Tacoma
11/13/2021,232,115027,115414,387,SC,2015,Toyota,Tacoma
11/20/2021,232,115414,116153,739,SC,2015,Toyota,Tacoma
11/27/2021,232,116153,116536,383,SC,2015,Toyota,Tacoma
12/4/2021,232,116536,116983,447,SC,2015,Toyota,Tacoma
12/11/2021,232,116983,117846,863,SC,2015,Toyota,Tacoma
12/18/2021,232,117846,118410,564,SC,2015,Toyota,Tacoma
12/25/2021,232,118410,118790,380,SC,2015,Toyota,Tacoma
10/2/2021,233,40266,40592,326,GS,2019,Nissan,Frontier
10/9/2021,233,40592,40781,189,GS,2019,Nissan,Frontier
10/16/2021,233,40781,41197,416,GS,2019,Nissan,Frontier
10/23/2021,233,41197,41379,182,GS,2019,Nissan,Frontier
10/30/2021,233,41379,41470,91,GS,2019,Nissan,Frontier
11/6/2021,233,41470,41894,424,GS,2019,Nissan,Frontier
11/13/2021,233,41894,42275,381,GS,2019,Nissan,Frontier
11/20/2021,233,42275,42554,279,GS,2019,Nissan,Frontier
11/27/2021,233,42554,42793,239,GS,2019,Nissan,Frontier
12/4/2021,233,42793,43026,233,GS,2019,Nissan,Frontier
12/11/2021,233,43026,43264,238,GS,2019,Nissan,Frontier
12/18/2021,233,43264,43849,585,GS,2019,Nissan,Frontier
1/9/2022,233,43849,44004,155,GS,2019,Nissan,Frontier
1/15/2022,233,44004,44510,506,GS,2019,Nissan,Frontier
1/29/2022,233,44510,44839,329,GS,2019,Nissan,Frontier
2/19/2022,233,45278,45897,619,GS,2019,Nissan,Frontier
2/26/2022,233,45897,46476,579,GS,2019,Nissan,Frontier
3/5/2022,233,46476,46837,361,GS,2019,Nissan,Frontier
3/12/2022,233,46837,47177,340,GS,2019,Nissan,Frontier
3/19/2022,233,47177,47651,474,GS,2019,Nissan,Frontier
3/26/2022,233,47651,47994,343,GS,2019,Nissan,Frontier
4/2/2022,233,47994,48578,584,GS,2019,Nissan,Frontier
10/2/2021,234,59470,60400,930,CS,2020,Toyota,Tacoma
10/9/2021,234,60400,61400,1000,CS,2020,Toyota,Tacoma
10/16/2021,234,61400,62307,907,CS,2020,Toyota,Tacoma
10/30/2021,234,63169,64072,903,CS,2020,Toyota,Tacoma
11/6/2021,234,64072,64883,811,CS,2020,Toyota,Tacoma
11/13/2021,234,64883,65500,617,CS,2020,Toyota,Tacoma
11/20/2021,234,65500,66345,845,CS,2020,Toyota,Tacoma
11/27/2021,234,66345,66783,438,CS,2020,Toyota,Tacoma
12/4/2021,234,66783,67530,747,CS,2020,Toyota,Tacoma
12/11/2021,234,67530,68070,540,CS,2020,Toyota,Tacoma
12/18/2021,234,68070,68841,771,CS,2020,Toyota,Tacoma
1/1/2022,234,68841,69517,676,CS,2020,Toyota,Tacoma
1/8/2022,234,69517,70263,746,CS,2020,Toyota,Tacoma
1/15/2022,234,70263,71095,832,CS,2020,Toyota,Tacoma
1/22/2022,234,71095,71751,656,CS,2020,Toyota,Tacoma
1/29/2022,234,71751,72405,654,CS,2020,Toyota,Tacoma
2/5/2022,234,72415,72832,417,CS,2020,Toyota,Tacoma
2/12/2022,234,72832,73536,704,CS,2020,Toyota,Tacoma
2/19/2022,234,73536,74000,464,CS,2020,Toyota,Tacoma
2/26/2022,234,74000,74629,629,CS,2020,Toyota,Tacoma
3/5/2022,234,74697,75805,1108,CS,2020,Toyota,Tacoma
3/12/2022,234,75805,76240,435,CS,2020,Toyota,Tacoma
3/19/2022,234,76240,76994,754,CS,2020,Toyota,Tacoma
3/26/2022,234,76994,77467,473,CS,2020,Toyota,Tacoma
4/2/2022,234,77467,78000,533,CS,2020,Toyota,Tacoma
10/2/2021,235,35604,36378,774,CS,2020,Toyota,Tacoma
10/9/2021,235,36378,37110,732,CS,2020,Toyota,Tacoma
10/16/2021,235,37110,37917,807,CS,2020,Toyota,Tacoma
10/23/2021,235,37917,38715,798,CS,2020,Toyota,Tacoma
10/30/2021,235,38715,39405,690,CS,2020,Toyota,Tacoma
11/6/2021,235,39405,40161,756,CS,2020,Toyota,Tacoma
11/13/2021,235,40161,40597,436,CS,2020,Toyota,Tacoma
11/20/2021,235,41012,41512,500,CS,2020,Toyota,Tacoma
11/27/2021,235,41512,41778,266,CS,2020,Toyota,Tacoma
12/4/2021,235,41778,42222,444,CS,2020,Toyota,Tacoma
12/11/2021,235,42222,42980,758,CS,2020,Toyota,Tacoma
12/18/2021,235,42980,43122,142,CS,2020,Toyota,Tacoma
12/25/2021,235,43122,43924,802,CS,2020,Toyota,Tacoma
1/1/2022,235,43924,44508,584,CS,2020,Toyota,Tacoma
1/9/2022,235,44508,45232,724,CS,2020,Toyota,Tacoma
1/15/2022,235,45232,46203,971,CS,2020,Toyota,Tacoma
1/22/2022,235,46203,46929,726,CS,2020,Toyota,Tacoma
1/29/2022,235,46929,47791,862,CS,2020,Toyota,Tacoma
2/5/2022,235,47791,48313,522,CS,2020,Toyota,Tacoma
2/26/2022,235,48313,49176,863,CS,2020,Toyota,Tacoma
2/26/2022,235,49176,49797,621,CS,2020,Toyota,Tacoma
3/5/2022,235,50210,50964,754,CS,2020,Toyota,Tacoma
3/12/2022,235,50964,51237,273,CS,2020,Toyota,Tacoma
3/26/2022,235,51988,52665,677,CS,2020,Toyota,Tacoma
4/2/2022,235,52665,53372,707,CS,2020,Toyota,Tacoma
10/2/2021,236,24619,25173,554,CS,2020,Toyota,Tacoma
10/9/2021,236,25173,25789,616,CS,2020,Toyota,Tacoma
10/16/2021,236,25789,26204,415,CS,2020,Toyota,Tacoma
10/23/2021,236,26204,26467,263,CS,2020,Toyota,Tacoma
10/30/2021,236,26467,26813,346,CS,2020,Toyota,Tacoma
11/6/2021,236,26813,27182,369,CS,2020,Toyota,Tacoma
11/13/2021,236,27182,27576,394,CS,2020,Toyota,Tacoma
11/27/2021,236,27579,27639,60,CS,2020,Toyota,Tacoma
12/4/2021,236,27639,27865,226,CS,2020,Toyota,Tacoma
12/11/2021,236,27865,28139,274,CS,2020,Toyota,Tacoma
12/18/2021,236,28139,28675,536,CS,2020,Toyota,Tacoma
12/25/2021,236,28675,29005,330,CS,2020,Toyota,Tacoma
1/1/2022,236,29005,29275,270,CS,2020,Toyota,Tacoma
1/8/2022,236,29275,29463,188,CS,2020,Toyota,Tacoma
1/15/2022,236,29463,29707,244,CS,2020,Toyota,Tacoma
1/22/2022,236,29707,30153,446,CS,2020,Toyota,Tacoma
1/29/2022,236,30153,30397,244,CS,2020,Toyota,Tacoma
2/5/2022,236,30397,30600,203,CS,2020,Toyota,Tacoma
2/12/2022,236,30600,30699,99,CS,2020,Toyota,Tacoma
2/19/2022,236,30699,30997,298,CS,2020,Toyota,Tacoma
2/26/2022,236,30997,31210,213,CS,2020,Toyota,Tacoma
3/5/2022,236,31210,31393,183,CS,2020,Toyota,Tacoma
3/12/2022,236,32073,32377,304,CS,2020,Toyota,Tacoma
3/19/2022,236,32377,33000,623,CS,2020,Toyota,Tacoma
3/26/2022,236,33000,33451,451,CS,2020,Toyota,Tacoma
4/2/2022,236,33451,33881,430,CS,2020,Toyota,Tacoma
9/25/2021,237,26200,26507,307,DN,2020,Toyota,Tacoma
10/2/2021,237,26507,26806,299,DN,2020,Toyota,Tacoma
10/9/2021,237,26806,27353,547,DN,2020,Toyota,Tacoma
10/16/2021,237,27353,27829,476,DN,2020,Toyota,Tacoma
10/30/2021,237,27829,28189,360,DN,2020,Toyota,Tacoma
11/6/2021,237,28189,28271,82,DN,2020,Toyota,Tacoma
11/20/2021,237,28829,29029,200,DN,2020,Toyota,Tacoma
11/27/2021,237,29029,29124,95,DN,2020,Toyota,Tacoma
12/4/2021,237,29124,29347,223,DN,2020,Toyota,Tacoma
12/11/2021,237,29347,29663,316,DN,2020,Toyota,Tacoma
12/18/2021,237,29663,30054,391,DN,2020,Toyota,Tacoma
12/25/2021,237,30054,30222,168,DN,2020,Toyota,Tacoma
1/8/2022,237,30222,30356,134,DN,2020,Toyota,Tacoma
1/15/2022,237,30557,30832,275,DN,2020,Toyota,Tacoma
1/22/2022,237,30832,31194,362,DN,2020,Toyota,Tacoma
1/29/2022,237,31194,31466,272,DN,2020,Toyota,Tacoma
2/5/2022,237,31466,31636,170,DN,2020,Toyota,Tacoma
2/12/2022,237,31636,31949,313,DN,2020,Toyota,Tacoma
2/19/2022,237,31949,32215,266,DN,2020,Toyota,Tacoma
2/26/2022,237,32215,32290,75,DN,2020,Toyota,Tacoma
3/5/2022,237,32290,32656,366,DN,2020,Toyota,Tacoma
3/26/2022,237,33077,33403,326,DN,2020,Toyota,Tacoma
10/2/2021,238,52741,53042,301,SC,2019,Toyota,Tacoma
10/9/2021,238,53042,53470,428,SC,2019,Toyota,Tacoma
10/16/2021,238,53470,53639,169,SC,2019,Toyota,Tacoma
10/23/2021,238,53639,54045,406,SC,2019,Toyota,Tacoma
10/30/2021,238,54045,54436,391,SC,2019,Toyota,Tacoma
11/6/2021,238,54436,54730,294,SC,2019,Toyota,Tacoma
11/13/2021,238,54730,55259,529,SC,2019,Toyota,Tacoma
11/20/2021,238,55259,55480,221,SC,2019,Toyota,Tacoma
2/19/2022,238,55549,55737,188,SC,2019,Toyota,Tacoma
3/5/2022,238,55737,55934,197,SC,2019,Toyota,Tacoma
9/25/2021,239,83993,84658,665,GS,2015,Toyota,Tacoma
10/2/2021,239,84658,85361,703,GS,2015,Toyota,Tacoma
10/16/2021,239,86037,86686,649,GS,2015,Toyota,Tacoma
12/11/2021,239,89846,90369,523,GS,2015,Toyota,Tacoma
1/15/2022,239,90717,90729,12,GS,2015,Toyota,Tacoma
2/19/2022,239,90746,91077,331,GS,2015,Toyota,Tacoma
2/26/2022,239,91077,91431,354,GS,2015,Toyota,Tacoma
3/5/2022,239,91431,91806,375,GS,2015,Toyota,Tacoma
3/12/2022,239,91806,92148,342,GS,2015,Toyota,Tacoma
3/19/2022,239,92148,92436,288,GS,2015,Toyota,Tacoma
3/26/2022,239,92436,93297,861,GS,2015,Toyota,Tacoma
4/2/2022,239,93297,94079,782,GS,2015,Toyota,Tacoma
9/18/2021,240,74115,74305,190,GS,2013,Toyota,Tacoma
10/9/2021,240,74305,74425,120,GS,2013,Toyota,Tacoma
10/16/2021,240,74425,74866,441,GS,2013,Toyota,Tacoma
10/23/2021,240,74866,74955,89,GS,2013,Toyota,Tacoma
10/30/2021,240,74955,75195,240,GS,2013,Toyota,Tacoma
11/6/2021,240,75195,75525,330,GS,2013,Toyota,Tacoma
11/13/2021,240,75525,75855,330,GS,2013,Toyota,Tacoma
11/20/2021,240,75855,76090,235,GS,2013,Toyota,Tacoma
11/27/2021,240,76090,76125,35,GS,2013,Toyota,Tacoma
12/4/2021,240,76125,76695,570,GS,2013,Toyota,Tacoma
12/11/2021,240,76695,76775,80,GS,2013,Toyota,Tacoma
12/18/2021,240,76775,77150,375,GS,2013,Toyota,Tacoma
12/25/2021,240,77150,77690,540,GS,2013,Toyota,Tacoma
1/8/2022,240,77690,77995,305,GS,2013,Toyota,Tacoma
1/15/2022,240,77995,78294,299,GS,2013,Toyota,Tacoma
1/22/2022,240,78294,78780,486,GS,2013,Toyota,Tacoma
1/29/2022,240,78780,78800,20,GS,2013,Toyota,Tacoma
2/5/2022,240,78800,78970,170,GS,2013,Toyota,Tacoma
2/19/2022,240,79342,79840,498,GS,2013,Toyota,Tacoma
3/5/2022,240,79840,80455,615,GS,2013,Toyota,Tacoma
3/12/2022,240,80455,80525,70,GS,2013,Toyota,Tacoma
3/19/2022,240,80525,80560,35,GS,2013,Toyota,Tacoma
3/26/2022,240,80660,80825,165,GS,2013,Toyota,Tacoma
4/2/2022,240,80825,80950,125,GS,2013,Toyota,Tacoma
10/2/2021,241,26026,26484,458,FC,2020,Toyota,Tacoma
10/9/2021,241,26484,26768,284,FC,2020,Toyota,Tacoma
10/16/2021,241,26768,27085,317,FC,2020,Toyota,Tacoma
10/23/2021,241,27085,27276,191,FC,2020,Toyota,Tacoma
10/30/2021,241,27276,27611,335,FC,2020,Toyota,Tacoma
11/6/2021,241,27611,28008,397,FC,2020,Toyota,Tacoma
11/13/2021,241,28008,28262,254,FC,2020,Toyota,Tacoma
11/20/2021,241,28262,28541,279,FC,2020,Toyota,Tacoma
11/27/2021,241,28541,28858,317,FC,2020,Toyota,Tacoma
12/4/2021,241,28858,29307,449,FC,2020,Toyota,Tacoma
12/11/2021,241,29307,29615,308,FC,2020,Toyota,Tacoma
12/18/2021,241,29615,30026,411,FC,2020,Toyota,Tacoma
12/25/2021,241,30026,30400,374,FC,2020,Toyota,Tacoma
1/1/2022,241,30400,30646,246,FC,2020,Toyota,Tacoma
1/8/2022,241,30646,30797,151,FC,2020,Toyota,Tacoma
1/15/2022,241,30797,30979,182,FC,2020,Toyota,Tacoma
1/22/2022,241,30979,31178,199,FC,2020,Toyota,Tacoma
1/29/2022,241,31178,31611,433,FC,2020,Toyota,Tacoma
2/5/2022,241,31611,31961,350,FC,2020,Toyota,Tacoma
2/12/2022,241,31961,32425,464,FC,2020,Toyota,Tacoma
2/19/2022,241,32425,32809,384,FC,2020,Toyota,Tacoma
2/26/2022,241,32809,32919,110,FC,2020,Toyota,Tacoma
3/5/2022,241,32919,33323,404,FC,2020,Toyota,Tacoma
3/12/2022,241,33323,33637,314,FC,2020,Toyota,Tacoma
3/19/2022,241,33637,33736,99,FC,2020,Toyota,Tacoma
3/26/2022,241,33736,34047,311,FC,2020,Toyota,Tacoma
10/2/2021,242,14895,15250,355,FC,2020,Toyota,Tacoma
10/9/2021,242,15250,15510,260,FC,2020,Toyota,Tacoma
10/16/2021,242,15510,15800,290,FC,2020,Toyota,Tacoma
10/23/2021,242,15800,15930,130,FC,2020,Toyota,Tacoma
10/30/2021,242,15930,16230,300,FC,2020,Toyota,Tacoma
11/6/2021,242,16230,16650,420,FC,2020,Toyota,Tacoma
11/13/2021,242,16650,16905,255,FC,2020,Toyota,Tacoma
11/20/2021,242,16905,17055,150,FC,2020,Toyota,Tacoma
11/27/2021,242,17055,17145,90,FC,2020,Toyota,Tacoma
12/4/2021,242,17145,17330,185,FC,2020,Toyota,Tacoma
12/11/2021,242,17330,17480,150,FC,2020,Toyota,Tacoma
12/18/2021,242,17480,17630,150,FC,2020,Toyota,Tacoma
1/1/2022,242,17630,17830,200,FC,2020,Toyota,Tacoma
1/8/2022,242,17830,18030,200,FC,2020,Toyota,Tacoma
1/15/2022,242,18030,18410,380,FC,2020,Toyota,Tacoma
1/22/2022,242,18410,18590,180,FC,2020,Toyota,Tacoma
1/29/2022,242,18590,18870,280,FC,2020,Toyota,Tacoma
2/5/2022,242,18870,19240,370,FC,2020,Toyota,Tacoma
2/12/2022,242,19240,19640,400,FC,2020,Toyota,Tacoma
2/19/2022,242,19640,19800,160,FC,2020,Toyota,Tacoma
2/26/2022,242,19800,20160,360,FC,2020,Toyota,Tacoma
3/5/2022,242,20160,20390,230,FC,2020,Toyota,Tacoma
3/12/2022,242,20390,20645,255,FC,2020,Toyota,Tacoma
3/19/2022,242,20645,20975,330,FC,2020,Toyota,Tacoma
3/26/2022,242,20975,21605,630,FC,2020,Toyota,Tacoma
4/2/2022,242,21605,22080,475,FC,2020,Toyota,Tacoma
10/2/2021,243,19999,20521,522,DN,2020,Toyota,Tacoma
10/9/2021,243,20521,20835,314,DN,2020,Toyota,Tacoma
10/16/2021,243,20835,21054,219,DN,2020,Toyota,Tacoma
10/23/2021,243,21054,21464,410,DN,2020,Toyota,Tacoma
10/30/2021,243,21464,21632,168,DN,2020,Toyota,Tacoma
11/6/2021,243,21632,22202,570,DN,2020,Toyota,Tacoma
11/13/2021,243,22202,22405,203,DN,2020,Toyota,Tacoma
11/20/2021,243,22405,22859,454,DN,2020,Toyota,Tacoma
11/27/2021,243,22930,23001,71,DN,2020,Toyota,Tacoma
12/4/2021,243,23001,23349,348,DN,2020,Toyota,Tacoma
12/11/2021,243,23349,23729,380,DN,2020,Toyota,Tacoma
12/18/2021,243,23729,23747,18,DN,2020,Toyota,Tacoma
12/25/2021,243,23747,23802,55,DN,2020,Toyota,Tacoma
1/1/2022,243,23802,23927,125,DN,2020,Toyota,Tacoma
1/8/2022,243,23927,24273,346,DN,2020,Toyota,Tacoma
1/15/2022,243,24273,24498,225,DN,2020,Toyota,Tacoma
2/5/2022,243,24685,24932,247,DN,2020,Toyota,Tacoma
2/12/2022,243,24932,25184,252,DN,2020,Toyota,Tacoma
2/19/2022,243,25184,25262,78,DN,2020,Toyota,Tacoma
2/26/2022,243,25262,25389,127,DN,2020,Toyota,Tacoma
3/5/2022,243,25389,25559,170,DN,2020,Toyota,Tacoma
3/12/2022,243,25635,25681,46,DN,2020,Toyota,Tacoma
3/19/2022,243,25681,26198,517,DN,2020,Toyota,Tacoma
3/26/2022,243,26198,26214,16,DN,2020,Toyota,Tacoma
10/30/2021,244,38110,39055,945,FC,2020,Toyota,Tacoma
11/6/2021,244,39055,39567,512,FC,2020,Toyota,Tacoma
11/13/2021,244,39567,40335,768,FC,2020,Toyota,Tacoma
11/20/2021,244,40335,40981,646,FC,2020,Toyota,Tacoma
12/25/2021,244,43720,44172,452,FC,2020,Toyota,Tacoma
1/1/2022,244,44172,44450,278,FC,2020,Toyota,Tacoma
1/15/2022,244,44450,44892,442,FC,2020,Toyota,Tacoma
1/22/2022,244,44892,45318,426,FC,2020,Toyota,Tacoma
1/29/2022,244,45318,45925,607,FC,2020,Toyota,Tacoma
2/5/2022,244,45925,46795,870,FC,2020,Toyota,Tacoma
2/12/2022,244,46795,47225,430,FC,2020,Toyota,Tacoma
2/19/2022,244,47225,48121,896,FC,2020,Toyota,Tacoma
2/26/2022,244,48121,48695,574,FC,2020,Toyota,Tacoma
3/5/2022,244,48695,49450,755,FC,2020,Toyota,Tacoma
3/12/2022,244,49450,50005,555,FC,2020,Toyota,Tacoma
3/19/2022,244,50005,51120,1115,FC,2020,Toyota,Tacoma
3/26/2022,244,51120,51375,255,FC,2020,Toyota,Tacoma
10/2/2021,245,15945,16527,582,DN,2021,Toyota,Tacoma
10/9/2021,245,16527,16861,334,DN,2021,Toyota,Tacoma
10/16/2021,245,16861,17149,288,DN,2021,Toyota,Tacoma
10/23/2021,245,17149,17441,292,DN,2021,Toyota,Tacoma
10/30/2021,245,17441,17821,380,DN,2021,Toyota,Tacoma
11/13/2021,245,18152,18448,296,DN,2021,Toyota,Tacoma
11/20/2021,245,18448,18826,378,DN,2021,Toyota,Tacoma
11/27/2021,245,18826,19050,224,DN,2021,Toyota,Tacoma
12/4/2021,245,19050,19426,376,DN,2021,Toyota,Tacoma
12/11/2021,245,19426,19890,464,DN,2021,Toyota,Tacoma
12/18/2021,245,19890,20320,430,DN,2021,Toyota,Tacoma
12/25/2021,245,20320,20815,495,DN,2021,Toyota,Tacoma
1/1/2022,245,20815,21400,585,DN,2021,Toyota,Tacoma
1/8/2022,245,21977,22457,480,DN,2021,Toyota,Tacoma
1/22/2022,245,22457,22808,351,DN,2021,Toyota,Tacoma
1/29/2022,245,22808,23447,639,DN,2021,Toyota,Tacoma
2/5/2022,245,23447,23986,539,DN,2021,Toyota,Tacoma
2/5/2022,245,24487,24868,381,DN,2021,Toyota,Tacoma
2/26/2022,245,24868,25192,324,DN,2021,Toyota,Tacoma
3/5/2022,245,25192,25683,491,DN,2021,Toyota,Tacoma
3/12/2022,245,25683,26220,537,DN,2021,Toyota,Tacoma
3/19/2022,245,26220,26465,245,DN,2021,Toyota,Tacoma
3/26/2022,245,26465,27034,569,DN,2021,Toyota,Tacoma
10/2/2021,246,14975,15340,365,DN,2021,Toyota,Tacoma
10/9/2021,246,15340,15666,326,DN,2021,Toyota,Tacoma
10/16/2021,246,15666,16115,449,DN,2021,Toyota,Tacoma
10/23/2021,246,16115,16414,299,DN,2021,Toyota,Tacoma
10/30/2021,246,16414,16867,453,DN,2021,Toyota,Tacoma
11/6/2021,246,16867,16989,122,DN,2021,Toyota,Tacoma
11/13/2021,246,16989,17318,329,DN,2021,Toyota,Tacoma
11/20/2021,246,17318,17613,295,DN,2021,Toyota,Tacoma
11/27/2021,246,17613,17977,364,DN,2021,Toyota,Tacoma
12/4/2021,246,17977,18222,245,DN,2021,Toyota,Tacoma
12/11/2021,246,18222,18498,276,DN,2021,Toyota,Tacoma
12/18/2021,246,18498,18743,245,DN,2021,Toyota,Tacoma
12/25/2021,246,18743,18969,226,DN,2021,Toyota,Tacoma
1/1/2022,246,18969,19111,142,DN,2021,Toyota,Tacoma
1/8/2022,246,19111,19368,257,DN,2021,Toyota,Tacoma
1/15/2022,246,19368,19632,264,DN,2021,Toyota,Tacoma
1/22/2022,246,19632,19896,264,DN,2021,Toyota,Tacoma
1/29/2022,246,19896,20173,277,DN,2021,Toyota,Tacoma
2/19/2022,246,20682,20962,280,DN,2021,Toyota,Tacoma
2/26/2022,246,20962,21258,296,DN,2021,Toyota,Tacoma
3/5/2022,246,21258,21597,339,DN,2021,Toyota,Tacoma
3/12/2022,246,21597,21861,264,DN,2021,Toyota,Tacoma
3/19/2022,246,21861,22142,281,DN,2021,Toyota,Tacoma
10/2/2021,247,28566,29286,720,GS,2021,Toyota,Tacoma
10/9/2021,247,29310,30265,955,GS,2021,Toyota,Tacoma
10/16/2021,247,30265,31155,890,GS,2021,Toyota,Tacoma
10/23/2021,247,31155,32060,905,GS,2021,Toyota,Tacoma
10/30/2021,247,32060,32780,720,GS,2021,Toyota,Tacoma
11/6/2021,247,32780,33445,665,GS,2021,Toyota,Tacoma
11/13/2021,247,33445,34640,1195,GS,2021,Toyota,Tacoma
11/20/2021,247,34640,35475,835,GS,2021,Toyota,Tacoma
11/27/2021,247,35475,36010,535,GS,2021,Toyota,Tacoma
12/4/2021,247,36010,37075,1065,GS,2021,Toyota,Tacoma
12/11/2021,247,37075,37795,720,GS,2021,Toyota,Tacoma
12/18/2021,247,37795,38620,825,GS,2021,Toyota,Tacoma
12/25/2021,247,38620,39275,655,GS,2021,Toyota,Tacoma
1/8/2022,247,39275,39860,585,GS,2021,Toyota,Tacoma
10/2/2021,248,12772,13565,793,GS,2021,Toyota,Tacoma
10/9/2021,248,13565,14315,750,GS,2021,Toyota,Tacoma
10/16/2021,248,14315,15042,727,GS,2021,Toyota,Tacoma
10/23/2021,248,15042,15637,595,GS,2021,Toyota,Tacoma
10/30/2021,248,15637,16258,621,GS,2021,Toyota,Tacoma
11/6/2021,248,16258,16999,741,GS,2021,Toyota,Tacoma
11/13/2021,248,16999,17674,675,GS,2021,Toyota,Tacoma
11/20/2021,248,17674,18135,461,GS,2021,Toyota,Tacoma
1/29/2022,248,39860,40075,215,GS,2021,Toyota,Tacoma
2/5/2022,248,40075,40820,745,GS,2021,Toyota,Tacoma
2/19/2022,248,41795,42645,850,GS,2021,Toyota,Tacoma
2/26/2022,248,42645,43555,910,GS,2021,Toyota,Tacoma
3/5/2022,248,43555,44225,670,GS,2021,Toyota,Tacoma
3/12/2022,248,44225,45195,970,GS,2021,Toyota,Tacoma
3/26/2022,248,46060,46900,840,GS,2021,Toyota,Tacoma
10/9/2021,249,31510,31697,187,PK,2019,Ford,F-150
10/16/2021,249,31697,31885,188,PK,2019,Ford,F-150
10/23/2021,249,31885,31996,111,PK,2019,Ford,F-150
10/30/2021,249,31996,32185,189,PK,2019,Ford,F-150
11/6/2021,249,32185,32410,225,PK,2019,Ford,F-150
11/13/2021,249,32410,32680,270,PK,2019,Ford,F-150
11/20/2021,249,32680,32843,163,PK,2019,Ford,F-150
11/27/2021,249,32843,32867,24,PK,2019,Ford,F-150
12/4/2021,249,32867,33130,263,PK,2019,Ford,F-150
12/11/2021,249,33130,33291,161,PK,2019,Ford,F-150
12/18/2021,249,33291,33530,239,PK,2019,Ford,F-150
1/15/2022,249,33813,34007,194,PK,2019,Ford,F-150
1/22/2022,249,34007,34193,186,PK,2019,Ford,F-150
1/29/2022,249,34193,34446,253,PK,2019,Ford,F-150
2/5/2022,249,34446,34643,197,PK,2019,Ford,F-150
2/19/2022,249,34890,35020,130,PK,2019,Ford,F-150
2/26/2022,249,35020,35148,128,PK,2019,Ford,F-150
3/5/2022,249,35148,35349,201,PK,2019,Ford,F-150
3/12/2022,249,35349,35545,196,PK,2019,Ford,F-150
3/19/2022,249,35545,35581,36,PK,2019,Ford,F-150
3/26/2022,249,35581,35721,140,PK,2019,Ford,F-150
4/2/2022,249,35721,35904,183,PK,2019,Ford,F-150
10/9/2021,250,37689,37869,180,DN,2017,Ford,F-150
10/16/2021,250,37869,38246,377,DN,2017,Ford,F-150
10/23/2021,250,38246,38710,464,DN,2017,Ford,F-150
10/30/2021,250,38733,39106,373,DN,2017,Ford,F-150
11/6/2021,250,39106,39431,325,DN,2017,Ford,F-150
11/13/2021,250,39431,39921,490,DN,2017,Ford,F-150
11/27/2021,250,40218,40333,115,DN,2017,Ford,F-150
12/4/2021,250,40333,40673,340,DN,2017,Ford,F-150
12/11/2021,250,40673,40981,308,DN,2017,Ford,F-150
12/18/2021,250,40981,41293,312,DN,2017,Ford,F-150
12/25/2021,250,41313,41501,188,DN,2017,Ford,F-150
1/15/2022,250,41653,41819,166,DN,2017,Ford,F-150
2/12/2022,250,42035,42652,617,DN,2017,Ford,F-150
2/26/2022,250,42842,43441,599,DN,2017,Ford,F-150
3/5/2022,250,43470,43630,160,DN,2017,Ford,F-150
3/12/2022,250,43630,44092,462,DN,2017,Ford,F-150
3/19/2022,250,44092,44618,526,DN,2017,Ford,F-150
3/26/2022,250,44618,44948,330,DN,2017,Ford,F-150
10/2/2021,251,3772,4146,374,DN,2021,Toyota,Tacoma
10/9/2021,251,4157,4675,518,DN,2021,Toyota,Tacoma
10/16/2021,251,4675,5076,401,DN,2021,Toyota,Tacoma
10/23/2021,251,5076,5394,318,DN,2021,Toyota,Tacoma
10/23/2021,251,5394,5863,469,DN,2021,Toyota,Tacoma
11/6/2021,251,5863,6406,543,DN,2021,Toyota,Tacoma
11/13/2021,251,6409,6914,505,DN,2021,Toyota,Tacoma
11/20/2021,251,6914,7328,414,DN,2021,Toyota,Tacoma
11/27/2021,251,7374,7860,486,DN,2021,Toyota,Tacoma
12/4/2021,251,7860,8851,991,DN,2021,Toyota,Tacoma
12/11/2021,251,8851,9788,937,DN,2021,Toyota,Tacoma
12/18/2021,251,9788,10619,831,DN,2021,Toyota,Tacoma
12/25/2021,251,10619,11315,696,DN,2021,Toyota,Tacoma
1/1/2022,251,11315,12096,781,DN,2021,Toyota,Tacoma
1/8/2022,251,12096,12983,887,DN,2021,Toyota,Tacoma
1/15/2022,251,12983,13881,898,DN,2021,Toyota,Tacoma
1/22/2022,251,13881,14653,772,DN,2021,Toyota,Tacoma
2/12/2022,251,14653,15709,1056,DN,2021,Toyota,Tacoma
2/19/2022,251,15709,16558,849,DN,2021,Toyota,Tacoma
2/26/2022,251,16558,17251,693,DN,2021,Toyota,Tacoma
3/5/2022,251,17251,18243,992,DN,2021,Toyota,Tacoma
3/12/2022,251,18243,19355,1112,DN,2021,Toyota,Tacoma
3/19/2022,251,19355,20142,787,DN,2021,Toyota,Tacoma
3/26/2022,251,20142,21148,1006,DN,2021,Toyota,Tacoma
10/2/2021,252,2008,2384,376,SC,2021,Toyota,Tacoma
10/9/2021,252,2384,3085,701,SC,2021,Toyota,Tacoma
10/16/2021,252,3085,3209,124,SC,2021,Toyota,Tacoma
10/23/2021,252,3209,3289,80,SC,2021,Toyota,Tacoma
10/30/2021,252,3289,3305,16,SC,2021,Toyota,Tacoma
11/6/2021,252,3305,3350,45,SC,2021,Toyota,Tacoma
11/13/2021,252,3350,3391,41,SC,2021,Toyota,Tacoma
11/20/2021,252,3391,3787,396,SC,2021,Toyota,Tacoma
11/27/2021,252,3787,4130,343,SC,2021,Toyota,Tacoma
12/4/2021,252,4130,4250,120,SC,2021,Toyota,Tacoma
12/11/2021,252,4250,4329,79,SC,2021,Toyota,Tacoma
12/18/2021,252,4329,4413,84,SC,2021,Toyota,Tacoma
1/8/2022,252,4413,4428,15,SC,2021,Toyota,Tacoma
1/15/2022,252,4428,4742,314,SC,2021,Toyota,Tacoma
1/22/2022,252,4742,5388,646,SC,2021,Toyota,Tacoma
1/29/2022,252,5388,5997,609,SC,2021,Toyota,Tacoma
2/5/2022,252,5997,6025,28,SC,2021,Toyota,Tacoma
2/19/2022,252,6600,6929,329,SC,2021,Toyota,Tacoma
2/26/2022,252,6929,6971,42,SC,2021,Toyota,Tacoma
3/5/2022,252,7040,7241,201,SC,2021,Toyota,Tacoma
3/12/2022,252,7241,7319,78,SC,2021,Toyota,Tacoma
3/19/2022,252,7319,7445,126,SC,2021,Toyota,Tacoma
3/26/2022,252,7445,7636,191,SC,2021,Toyota,Tacoma
1/15/2022,253,1608,1771,163,FC,2021,Ford,F-150
1/22/2022,253,1771,2202,431,FC,2021,Ford,F-150
2/5/2022,253,2511,2666,155,FC,2021,Ford,F-150
2/12/2022,253,2673,3269,596,FC,2021,Ford,F-150
2/19/2022,253,3270,3538,268,FC,2021,Ford,F-150
2/26/2022,253,3646,3874,228,FC,2021,Ford,F-150
3/5/2022,253,3881,4397,516,FC,2021,Ford,F-150
3/12/2022,253,4397,4699,302,FC,2021,Ford,F-150
3/19/2022,253,4699,5263,564,FC,2021,Ford,F-150
3/26/2022,253,5263,6042,779,FC,2021,Ford,F-150
4/2/2022,253,6042,6403,361,FC,2021,Ford,F-150
1/22/2022,254,268,765,497,GS,2022,Toyota,Tacoma
1/29/2022,254,765,1088,323,GS,2022,Toyota,Tacoma
2/5/2022,254,1088,1514,426,GS,2022,Toyota,Tacoma
2/12/2022,254,1514,1805,291,GS,2022,Toyota,Tacoma
2/19/2022,254,1805,2067,262,GS,2022,Toyota,Tacoma
2/26/2022,254,2067,2345,278,GS,2022,Toyota,Tacoma
3/5/2022,254,2345,2684,339,GS,2022,Toyota,Tacoma
3/12/2022,254,2684,3161,477,GS,2022,Toyota,Tacoma
3/19/2022,254,3161,3571,410,GS,2022,Toyota,Tacoma
3/26/2022,254,3571,3990,419,GS,2022,Toyota,Tacoma
4/2/2022,254,3990,4284,294,GS,2022,Toyota,Tacoma
10/2/2021,692,266828,266993,165,GS,2000,Ford,F-150
12/11/2021,692,267175,268000,825,GS,2000,Ford,F-150
12/18/2021,692,268000,268500,500,GS,2000,Ford,F-150
12/25/2021,692,268500,268590,90,GS,2000,Ford,F-150
1/15/2022,692,268590,269350,760,GS,2000,Ford,F-150
1/22/2022,692,269350,269850,500,GS,2000,Ford,F-150
1/29/2022,692,269850,270600,750,GS,2000,Ford,F-150
2/5/2022,692,270600,270830,230,GS,2000,Ford,F-150
3/12/2022,692,270920,270990,70,GS,2000,Ford,F-150
10/9/2021,729,258656,258878,222,PK,2007,Toyota,Tacoma
10/2/2021,730,177155,177623,468,SC,2007,Toyota,Tacoma
10/9/2021,730,177623,178648,1025,SC,2007,Toyota,Tacoma
10/16/2021,730,178648,179413,765,SC,2007,Toyota,Tacoma
10/23/2021,730,179413,180466,1053,SC,2007,Toyota,Tacoma
10/30/2021,730,180466,181214,748,SC,2007,Toyota,Tacoma
11/6/2021,730,181214,181936,722,SC,2007,Toyota,Tacoma
11/13/2021,730,181936,182780,844,SC,2007,Toyota,Tacoma
10/2/2021,732,264842,265339,497,DN,2007,Toyota,Tacoma
10/9/2021,732,265339,265622,283,DN,2007,Toyota,Tacoma
10/16/2021,732,265662,265987,325,DN,2007,Toyota,Tacoma
10/23/2021,732,265987,266276,289,DN,2007,Toyota,Tacoma
10/30/2021,732,266276,266624,348,DN,2007,Toyota,Tacoma
11/6/2021,732,266692,267063,371,DN,2007,Toyota,Tacoma
11/13/2021,732,267128,267442,314,DN,2007,Toyota,Tacoma
11/20/2021,732,267442,267995,553,DN,2007,Toyota,Tacoma
11/27/2021,732,267995,268105,110,DN,2007,Toyota,Tacoma
10/2/2021,733,177037,177601,564,SC,2007,Toyota,Tacoma
10/9/2021,733,177601,177792,191,SC,2007,Toyota,Tacoma
10/16/2021,733,177792,178029,237,SC,2007,Toyota,Tacoma
10/23/2021,733,178029,178223,194,SC,2007,Toyota,Tacoma
10/30/2021,733,178223,178864,641,SC,2007,Toyota,Tacoma
11/6/2021,733,178864,178876,12,SC,2007,Toyota,Tacoma
10/2/2021,737,238982,239380,398,GS,2012,Toyota,Tacoma
10/9/2021,737,239380,239606,226,GS,2012,Toyota,Tacoma
10/16/2021,737,239606,239793,187,GS,2012,Toyota,Tacoma
10/23/2021,737,239793,240104,311,GS,2012,Toyota,Tacoma
10/30/2021,737,240104,240284,180,GS,2012,Toyota,Tacoma
11/6/2021,737,240284,240783,499,GS,2012,Toyota,Tacoma
11/13/2021,737,240783,241028,245,GS,2012,Toyota,Tacoma
11/27/2021,737,241028,241243,215,GS,2012,Toyota,Tacoma
12/4/2021,737,241243,241673,430,GS,2012,Toyota,Tacoma
12/11/2021,737,241673,241785,112,GS,2012,Toyota,Tacoma
12/18/2021,737,241785,242095,310,GS,2012,Toyota,Tacoma
10/2/2021,738,110489,110940,451,SC,2012,Toyota,Tacoma
10/9/2021,738,110940,111879,939,SC,2012,Toyota,Tacoma
10/16/2021,738,111879,112478,599,SC,2012,Toyota,Tacoma
10/23/2021,738,112478,113155,677,SC,2012,Toyota,Tacoma
10/30/2021,738,113155,113881,726,SC,2012,Toyota,Tacoma
11/6/2021,738,113881,114750,869,SC,2012,Toyota,Tacoma
11/13/2021,738,114750,115520,770,SC,2012,Toyota,Tacoma
11/20/2021,738,115520,116455,935,SC,2012,Toyota,Tacoma
11/27/2021,738,116455,117049,594,SC,2012,Toyota,Tacoma
12/4/2021,738,117049,117887,838,SC,2012,Toyota,Tacoma
12/11/2021,738,117887,118586,699,SC,2012,Toyota,Tacoma
12/18/2021,738,118586,119419,833,SC,2012,Toyota,Tacoma
12/25/2021,738,119419,119877,458,SC,2012,Toyota,Tacoma
1/8/2022,738,119929,120343,414,SC,2012,Toyota,Tacoma
1/15/2022,738,120343,121062,719,SC,2012,Toyota,Tacoma
1/22/2022,738,121062,121230,168,SC,2012,Toyota,Tacoma
1/29/2022,738,121230,121919,689,SC,2012,Toyota,Tacoma
2/5/2022,738,121919,122778,859,SC,2012,Toyota,Tacoma
2/19/2022,738,123678,124520,842,SC,2012,Toyota,Tacoma
2/26/2022,738,124520,124966,446,SC,2012,Toyota,Tacoma
3/5/2022,738,124966,125852,886,SC,2012,Toyota,Tacoma
3/12/2022,738,125852,126143,291,SC,2012,Toyota,Tacoma
3/19/2022,738,126143,126985,842,SC,2012,Toyota,Tacoma
3/26/2022,738,126985,127678,693,SC,2012,Toyota,Tacoma
10/9/2021,739,181006,181698,692,PK,2012,Toyota,Tacoma
10/16/2021,739,181698,182261,563,PK,2012,Toyota,Tacoma
10/23/2021,739,182261,182767,506,PK,2012,Toyota,Tacoma
10/30/2021,739,182767,183270,503,PK,2012,Toyota,Tacoma
11/6/2021,739,183270,183743,473,PK,2012,Toyota,Tacoma
11/13/2021,739,183743,184190,447,PK,2012,Toyota,Tacoma
11/20/2021,739,184190,184325,135,PK,2012,Toyota,Tacoma
12/11/2021,739,184325,184589,264,PK,2012,Toyota,Tacoma
12/18/2021,739,184589,184689,100,PK,2012,Toyota,Tacoma
1/15/2022,739,185526,185808,282,PK,2012,Toyota,Tacoma
1/22/2022,739,185808,186260,452,PK,2012,Toyota,Tacoma
1/29/2022,739,186260,186747,487,PK,2012,Toyota,Tacoma
2/5/2022,739,186747,187189,442,PK,2012,Toyota,Tacoma
2/19/2022,739,187604,187967,363,PK,2012,Toyota,Tacoma
2/26/2022,739,187967,188294,327,PK,2012,Toyota,Tacoma
3/5/2022,739,188294,188754,460,PK,2012,Toyota,Tacoma
3/12/2022,739,188754,189162,408,PK,2012,Toyota,Tacoma
3/19/2022,739,189162,189680,518,PK,2012,Toyota,Tacoma
3/26/2022,739,189680,190291,611,PK,2012,Toyota,Tacoma
4/2/2022,739,190291,190882,591,PK,2012,Toyota,Tacoma
4/9/2022,739,190882,191559,677,PK,2012,Toyota,Tacoma
4/16/2022,739,191559,192187,628,PK,2012,Toyota,Tacoma
9/25/2021,740,126441,126606,165,DN,2012,Toyota,Tacoma
10/9/2021,740,126846,127134,288,DN,2012,Toyota,Tacoma
10/16/2021,740,127134,127458,324,DN,2012,Toyota,Tacoma
10/23/2021,740,127458,128156,698,DN,2012,Toyota,Tacoma
10/30/2021,740,128156,128684,528,DN,2012,Toyota,Tacoma
11/6/2021,740,128684,129226,542,DN,2012,Toyota,Tacoma
11/20/2021,740,129717,130259,542,DN,2012,Toyota,Tacoma
12/4/2021,740,130474,131035,561,DN,2012,Toyota,Tacoma
12/18/2021,740,131660,132110,450,DN,2012,Toyota,Tacoma
12/25/2021,740,132110,132662,552,DN,2012,Toyota,Tacoma
1/8/2022,740,132662,133033,371,DN,2012,Toyota,Tacoma
1/22/2022,740,133555,134094,539,DN,2012,Toyota,Tacoma
1/29/2022,740,134094,134473,379,DN,2012,Toyota,Tacoma
2/5/2022,740,134473,134662,189,DN,2012,Toyota,Tacoma
2/12/2022,740,134662,135205,543,DN,2012,Toyota,Tacoma
2/19/2022,740,135205,135562,357,DN,2012,Toyota,Tacoma
2/26/2022,740,135562,135669,107,DN,2012,Toyota,Tacoma
3/5/2022,740,135717,136276,559,DN,2012,Toyota,Tacoma
3/12/2022,740,136276,136685,409,DN,2012,Toyota,Tacoma
3/26/2022,740,137122,137704,582,DN,2012,Toyota,Tacoma
10/2/2021,741,195725,196075,350,DN,2013,Toyota,Tacoma
10/9/2021,741,196075,196325,250,DN,2013,Toyota,Tacoma
10/16/2021,741,196325,196625,300,DN,2013,Toyota,Tacoma
10/23/2021,741,196625,196975,350,DN,2013,Toyota,Tacoma
10/30/2021,741,196975,197425,450,DN,2013,Toyota,Tacoma
11/6/2021,741,197425,197800,375,DN,2013,Toyota,Tacoma
11/20/2021,741,198050,198425,375,DN,2013,Toyota,Tacoma
11/27/2021,741,198425,198700,275,DN,2013,Toyota,Tacoma
12/11/2021,741,199000,199200,200,DN,2013,Toyota,Tacoma
12/25/2021,741,199400,199650,250,DN,2013,Toyota,Tacoma
1/8/2022,741,199700,200100,400,DN,2013,Toyota,Tacoma
1/15/2022,741,200100,200500,400,DN,2013,Toyota,Tacoma
1/22/2022,741,200500,200850,350,DN,2013,Toyota,Tacoma
2/5/2022,741,201000,201350,350,DN,2013,Toyota,Tacoma
2/19/2022,741,201600,201900,300,DN,2013,Toyota,Tacoma
2/26/2022,741,201900,202150,250,DN,2013,Toyota,Tacoma
3/5/2022,741,202150,202450,300,DN,2013,Toyota,Tacoma
3/12/2022,741,202450,202650,200,DN,2013,Toyota,Tacoma
3/26/2022,741,202975,203135,160,DN,2013,Toyota,Tacoma
10/9/2021,743,152001,152406,405,PK,2015,Toyota,Tacoma
10/16/2021,743,152406,152907,501,PK,2015,Toyota,Tacoma
10/23/2021,743,152907,153720,813,PK,2015,Toyota,Tacoma
10/30/2021,743,153720,154364,644,PK,2015,Toyota,Tacoma
11/6/2021,743,154364,154811,447,PK,2015,Toyota,Tacoma
11/13/2021,743,154811,155226,415,PK,2015,Toyota,Tacoma
11/20/2021,743,155228,155232,4,PK,2015,Toyota,Tacoma
11/27/2021,743,155232,155581,349,PK,2015,Toyota,Tacoma
12/4/2021,743,155581,155947,366,PK,2015,Toyota,Tacoma
12/11/2021,743,156001,156207,206,PK,2015,Toyota,Tacoma
12/18/2021,743,156277,156658,381,PK,2015,Toyota,Tacoma
1/15/2022,743,156930,157302,372,PK,2015,Toyota,Tacoma
1/22/2022,743,157302,157700,398,PK,2015,Toyota,Tacoma
1/29/2022,743,157700,157919,219,PK,2015,Toyota,Tacoma
2/5/2022,743,157919,158327,408,PK,2015,Toyota,Tacoma
2/19/2022,743,158808,159113,305,PK,2015,Toyota,Tacoma
2/26/2022,743,159113,159340,227,PK,2015,Toyota,Tacoma
3/5/2022,743,159340,159632,292,PK,2015,Toyota,Tacoma
3/12/2022,743,159632,159838,206,PK,2015,Toyota,Tacoma
3/19/2022,743,159838,160178,340,PK,2015,Toyota,Tacoma
3/26/2022,743,160178,160460,282,PK,2015,Toyota,Tacoma
4/2/2022,743,160460,160835,375,PK,2015,Toyota,Tacoma
4/9/2022,743,160851,161228,377,PK,2015,Toyota,Tacoma
4/16/2022,743,161228,161527,299,PK,2015,Toyota,Tacoma
10/2/2021,745,122179,122799,620,PK,2015,Toyota,Tacoma
10/9/2021,745,122799,123286,487,PK,2015,Toyota,Tacoma
10/23/2021,745,123746,124315,569,PK,2015,Toyota,Tacoma
10/30/2021,745,124315,124820,505,PK,2015,Toyota,Tacoma
11/6/2021,745,124820,125352,532,PK,2015,Toyota,Tacoma
11/13/2021,745,125352,126018,666,PK,2015,Toyota,Tacoma
11/20/2021,745,126018,126483,465,PK,2015,Toyota,Tacoma
11/27/2021,745,126483,126900,417,PK,2015,Toyota,Tacoma
12/4/2021,745,126900,127441,541,PK,2015,Toyota,Tacoma
12/11/2021,745,127441,128061,620,PK,2015,Toyota,Tacoma
12/18/2021,745,128061,128291,230,PK,2015,Toyota,Tacoma
1/15/2022,745,129039,129688,649,PK,2015,Toyota,Tacoma
1/22/2022,745,129688,130393,705,PK,2015,Toyota,Tacoma
2/5/2022,745,131248,132206,958,PK,2015,Toyota,Tacoma
10/2/2021,746,139273,140385,1112,DN,2015,Chevy,Colorado
10/9/2021,746,140385,141121,736,DN,2015,Chevy,Colorado
10/23/2021,746,141141,142023,882,DN,2015,Chevy,Colorado
11/6/2021,746,143053,144001,948,DN,2015,Chevy,Colorado
11/13/2021,746,144001,145100,1099,DN,2015,Chevy,Colorado
11/20/2021,746,145100,145964,864,DN,2015,Chevy,Colorado
12/25/2021,746,146270,146624,354,DN,2015,Chevy,Colorado
1/8/2022,746,146698,146740,42,DN,2015,Chevy,Colorado
1/22/2022,746,146982,147267,285,DN,2015,Chevy,Colorado
1/29/2022,746,147276,147710,434,DN,2015,Chevy,Colorado
2/5/2022,746,147868,148060,192,DN,2015,Chevy,Colorado
2/12/2022,746,148060,148415,355,DN,2015,Chevy,Colorado
2/19/2022,746,148439,148883,444,DN,2015,Chevy,Colorado
2/26/2022,746,148920,149089,169,DN,2015,Chevy,Colorado
3/5/2022,746,149089,149318,229,DN,2015,Chevy,Colorado
3/12/2022,746,149318,149613,295,DN,2015,Chevy,Colorado
3/26/2022,746,149921,150107,186,DN,2015,Chevy,Colorado
9/25/2021,748,166286,167066,780,GS,2015,Toyota,Tacoma
10/2/2021,748,167066,167686,620,GS,2015,Toyota,Tacoma
11/20/2021,748,171655,172240,585,GS,2015,Toyota,Tacoma
